"ad" = (/obj/structure/destructible/cult/talisman,/obj/effect/mob_spawn/human/corpse/cook,/obj/item/cult_bastard,/obj/effect/decal/cleanable/blood,/obj/effect/decal/cleanable/dirt/dust,/turf/open/floor/iron/cult,/area/ruin/lavaland/unpowered)
"aN" = (/obj/effect/decal/cleanable/cobweb/cobweb2,/turf/open/floor/iron/cult,/area/ruin/lavaland/unpowered)
"bC" = (/turf/open/floor/plating/asteroid/basalt/wasteland,/area/ruin/lavaland/unpowered)
"bR" = (/obj/item/restraints/legcuffs/bola/cult,/turf/open/floor/iron/cult,/area/ruin/lavaland/unpowered)
"bZ" = (/obj/item/tcg_card/special/abductor,/turf/open/floor/iron/cult,/area/ruin/lavaland/unpowered)
"cd" = (/obj/effect/decal/cleanable/blood/tracks,/turf/open/floor/iron/cult,/area/ruin/lavaland/unpowered)
"cm" = (/obj/item/retractor/alien,/turf/open/floor/plating/abductor,/area/ruin/lavaland/unpowered)
"cu" = (/obj/item/melee/cultblade/dagger,/turf/open/floor/iron/cult,/area/ruin/lavaland/unpowered)
"dc" = (/obj/effect/decal/remains/human,/turf/open/floor/iron/cult,/area/ruin/lavaland/unpowered)
"dE" = (/obj/structure/trap/chill,/turf/open/floor/iron/cult,/area/ruin/lavaland/unpowered)
"fs" = (/obj/structure/destructible/cult/talisman,/obj/item/clothing/suit/cultrobes,/turf/open/floor/iron/cult,/area/ruin/lavaland/unpowered)
"ft" = (/obj/effect/decal/cleanable/blood/old,/obj/item/stack/spacecash/c1000,/turf/open/floor/iron/cult,/area/ruin/lavaland/unpowered)
"fE" = (/obj/effect/mob_spawn/human/corpse/cook,/turf/open/floor/iron/cult,/area/ruin/lavaland/unpowered)
"fT" = (/turf/closed/wall/mineral/cult,/area/ruin/lavaland/unpowered)
"gf" = (/mob/living/simple_animal/hostile/cult/spear,/obj/effect/decal/cleanable/blood/drip,/turf/open/floor/iron/cult,/area/ruin/lavaland/unpowered)
"gm" = (/obj/effect/decal/cleanable/blood/old,/turf/open/floor/iron/cult,/area/ruin/lavaland/unpowered)
"hk" = (/obj/item/storage/fancy/cigarettes/cigpack_mindbreaker,/obj/structure/table/wood/fancy/royalblack,/turf/open/floor/iron/cult,/area/ruin/lavaland/unpowered)
"hm" = (/obj/item/restraints/legcuffs/bola/cult,/obj/effect/decal/cleanable/cobweb/cobweb2,/turf/open/floor/iron/cult,/area/ruin/lavaland/unpowered)
"hn" = (/obj/effect/decal/cleanable/blood/gibs/human/limb,/turf/open/floor/iron/cult,/area/ruin/lavaland/unpowered)
"hv" = (/obj/effect/decal/cleanable/blood/gibs/human/body,/turf/open/floor/iron/cult,/area/ruin/lavaland/unpowered)
"hC" = (/obj/effect/mob_spawn/human/abductor,/turf/open/floor/grass/grass0,/area/ruin/lavaland/unpowered)
"hP" = (/obj/item/storage/fancy/cigarettes/cigpack_mindbreaker,/turf/open/floor/iron/cult,/area/ruin/lavaland/unpowered)
"ig" = (/obj/item/stack/spacecash/c100,/turf/open/floor/iron/cult,/area/ruin/lavaland/unpowered)
"jy" = (/obj/effect/rune/raise_dead,/obj/item/stack/sheet/runed_metal/five,/obj/effect/decal/cleanable/dirt/dust,/obj/effect/decal/cleanable/dirt/dust,/turf/open/floor/iron/cult,/area/ruin/lavaland/unpowered)
"kt" = (/obj/structure/destructible/cult/forge,/obj/item/cult_spear,/obj/effect/decal/cleanable/blood,/turf/open/floor/iron/cult,/area/ruin/lavaland/unpowered)
"kR" = (/obj/item/restraints/legcuffs/beartrap/bloodsucker,/obj/effect/decal/cleanable/dirt/dust,/turf/open/floor/iron/cult,/area/ruin/lavaland/unpowered)
"lf" = (/mob/living/simple_animal/hostile/cult/warrior,/turf/open/floor/iron/cult,/area/ruin/lavaland/unpowered)
"lp" = (/obj/structure/flora/rock,/turf/open/floor/plating/asteroid/basalt/lava,/area/ruin/lavaland/unpowered)
"lG" = (/obj/effect/decal/cleanable/blood/tracks{dir = 8},/turf/open/floor/iron/cult,/area/ruin/lavaland/unpowered)
"lZ" = (/obj/item/organ/eyes,/turf/open/floor/iron/cult,/area/ruin/lavaland/unpowered)
"mw" = (/obj/structure/spirit_board,/turf/open/floor/iron/cult,/area/ruin/lavaland/unpowered)
"mF" = (/mob/living/simple_animal/hostile/cult/warrior,/obj/effect/decal/cleanable/cobweb/cobweb2,/turf/open/floor/iron/cult,/area/ruin/lavaland/unpowered)
"mI" = (/obj/item/melee/cultblade/dagger,/obj/structure/destructible/cult/tome,/obj/item/organ/heart/cursed,/turf/open/floor/iron/cult,/area/ruin/lavaland/unpowered)
"mM" = (/turf/open/floor/plating/dirt/dark,/area/ruin/lavaland/unpowered)
"os" = (/obj/effect/decal/cleanable/blood,/turf/open/floor/iron/cult,/area/ruin/lavaland/unpowered)
"oz" = (/obj/item/kitchen/knife/bloodletter,/turf/open/floor/iron/cult,/area/ruin/lavaland/unpowered)
"pZ" = (/obj/item/clothing/glasses/hud/health/night/cultblind,/turf/open/floor/iron/cult,/area/ruin/lavaland/unpowered)
"qr" = (/obj/effect/decal/cleanable/blood,/obj/item/organ/lungs,/turf/open/floor/iron/cult,/area/ruin/lavaland/unpowered)
"qO" = (/obj/effect/mob_spawn/human/skeleton,/turf/open/floor/plating/asteroid/basalt/wasteland,/area/ruin/lavaland/unpowered)
"rP" = (/obj/item/cult_halberd,/obj/effect/decal/cleanable/dirt/dust,/turf/open/floor/iron/cult,/area/ruin/lavaland/unpowered)
"sc" = (/obj/item/clothing/suit/cultrobes,/turf/open/floor/iron/cult,/area/ruin/lavaland/unpowered)
"sz" = (/mob/living/simple_animal/hostile/cult/magic/elite,/obj/effect/decal/cleanable/dirt/dust,/turf/open/floor/iron/cult,/area/ruin/lavaland/unpowered)
"sH" = (/obj/item/clothing/suit/hooded/cultrobes/eldritch,/obj/structure/destructible/cult/talisman,/turf/open/floor/iron/cult,/area/ruin/lavaland/unpowered)
"sI" = (/obj/structure/flora/rock,/turf/open/floor/plating/asteroid/basalt/wasteland,/area/ruin/lavaland/unpowered)
"sJ" = (/turf/open/floor/iron/cult,/area/ruin/lavaland/unpowered)
"tD" = (/obj/effect/forcefield/cult,/turf/closed/mineral/random/low_chance,/area/ruin/lavaland/unpowered)
"vh" = (/obj/effect/mob_spawn/human/skeleton,/turf/open/floor/plating/dirt/dark,/area/ruin/lavaland/unpowered)
"vr" = (/obj/effect/decal/cleanable/blood/drip,/turf/open/floor/iron/cult,/area/ruin/lavaland/unpowered)
"vM" = (/obj/effect/decal/cleanable/blood/gibs/human/body,/obj/effect/decal/cleanable/dirt/dust,/turf/open/floor/iron/cult,/area/ruin/lavaland/unpowered)
"wf" = (/mob/living/simple_animal/hostile/cultleader,/turf/open/floor/iron/cult,/area/ruin/lavaland/unpowered)
"wQ" = (/obj/structure/closet/crate/grave,/turf/open/floor/plating/asteroid/basalt/wasteland,/area/ruin/lavaland/unpowered)
"xq" = (/obj/structure/flora/rock,/turf/open/floor/plating/dirt/dark,/area/ruin/lavaland/unpowered)
"xQ" = (/mob/living/simple_animal/hostile/cult/ghost,/turf/open/floor/iron/cult,/area/ruin/lavaland/unpowered)
"xW" = (/obj/structure/destructible/cult/pylon,/turf/open/floor/iron/cult,/area/ruin/lavaland/unpowered)
"yj" = (/obj/structure/door_assembly/door_assembly_cult{anchored = 1},/turf/open/floor/iron/cult,/area/ruin/lavaland/unpowered)
"zm" = (/obj/effect/decal/cleanable/blood/gibs/human/core,/turf/open/floor/iron/cult,/area/ruin/lavaland/unpowered)
"zZ" = (/obj/item/organ/tongue,/turf/open/floor/iron/cult,/area/ruin/lavaland/unpowered)
"AY" = (/obj/effect/mob_spawn/human/abductor,/obj/effect/decal/cleanable/dirt/dust,/turf/open/floor/iron/cult,/area/ruin/lavaland/unpowered)
"BI" = (/obj/structure/table/optable/abductor,/obj/item/clothing/glasses/hud/health/night/cultblind,/obj/item/organ/eyes/night_vision/wendigo,/turf/open/floor/plating/abductor,/area/ruin/lavaland/unpowered)
"Cp" = (/obj/effect/decal/cleanable/dirt/dust,/turf/open/floor/iron/cult,/area/ruin/lavaland/unpowered)
"Dy" = (/obj/structure/table/abductor,/turf/open/floor/plating/abductor,/area/ruin/lavaland/unpowered)
"DA" = (/obj/item/restraints/legcuffs/beartrap/bloodsucker,/turf/open/floor/iron/cult,/area/ruin/lavaland/unpowered)
"Em" = (/obj/structure/bonfire/prelit,/turf/open/floor/plating/asteroid/basalt/lava,/area/ruin/lavaland/unpowered)
"EZ" = (/obj/item/paper/crumpled/bloody/docsdeathnote,/obj/effect/decal/cleanable/dirt/dust,/turf/open/floor/iron/cult,/area/ruin/lavaland/unpowered)
"Fl" = (/obj/item/stack/sheet/runed_metal/five,/obj/effect/decal/cleanable/dirt/dust,/turf/open/floor/iron/cult,/area/ruin/lavaland/unpowered)
"Fy" = (/obj/item/surgical_drapes,/turf/open/floor/iron/cult,/area/ruin/lavaland/unpowered)
"FB" = (/obj/structure/trap/stun,/turf/open/floor/iron/cult,/area/ruin/lavaland/unpowered)
"FH" = (/turf/open/lava/smooth/lava_land_surface,/area/ruin/lavaland/unpowered)
"FK" = (/obj/effect/decal/cleanable/blood/gibs/human/down,/obj/effect/decal/cleanable/dirt/dust,/turf/open/floor/iron/cult,/area/ruin/lavaland/unpowered)
"GK" = (/obj/item/bedsheet/cult,/obj/structure/bed,/turf/open/floor/iron/cult,/area/ruin/lavaland/unpowered)
"HA" = (/obj/structure/bed,/obj/item/bedsheet/cult,/turf/open/floor/iron/cult,/area/ruin/lavaland/unpowered)
"HK" = (/mob/living/simple_animal/hostile/cult/assassin,/turf/open/floor/iron/cult,/area/ruin/lavaland/unpowered)
"HN" = (/obj/structure/bonfire/prelit,/turf/open/floor/iron/cult,/area/ruin/lavaland/unpowered)
"Ih" = (/obj/item/clothing/suit/space/hardsuit/cult,/obj/item/stack/sheet/runed_metal/five,/turf/open/floor/iron/cult,/area/ruin/lavaland/unpowered)
"Iu" = (/obj/effect/decal/remains/human,/obj/effect/decal/cleanable/dirt/dust,/turf/open/floor/iron/cult,/area/ruin/lavaland/unpowered)
"IP" = (/turf/open/floor/plating/asteroid/basalt/lava,/area/ruin/lavaland/unpowered)
"Jz" = (/obj/item/storage/backpack/cultpack,/turf/open/floor/iron/cult,/area/ruin/lavaland/unpowered)
"JB" = (/obj/structure/table/abductor,/turf/open/floor/iron/cult,/area/ruin/lavaland/unpowered)
"JI" = (/obj/machinery/door/airlock/cult/friendly,/turf/open/floor/iron/cult,/area/ruin/lavaland/unpowered)
"JY" = (/obj/item/clothing/shoes/cult/alt,/turf/open/floor/iron/cult,/area/ruin/lavaland/unpowered)
"Kh" = (/obj/item/stack/sheet/runed_metal/ten,/turf/open/floor/iron/cult,/area/ruin/lavaland/unpowered)
"Km" = (/obj/effect/decal/cleanable/generic,/obj/effect/decal/cleanable/dirt/dust,/turf/open/floor/iron/cult,/area/ruin/lavaland/unpowered)
"Kr" = (/obj/structure/door_assembly/door_assembly_cult/unruned{anchored = 1},/turf/open/floor/iron/cult,/area/ruin/lavaland/unpowered)
"Ku" = (/obj/item/organ/eyes,/obj/effect/decal/cleanable/blood,/turf/open/floor/iron/cult,/area/ruin/lavaland/unpowered)
"Li" = (/obj/item/stack/sheet/runed_metal/five,/turf/open/floor/iron/cult,/area/ruin/lavaland/unpowered)
"Lr" = (/obj/effect/decal/cleanable/dirt/dust,/turf/open/floor/plating/abductor,/area/ruin/lavaland/unpowered)
"Mg" = (/mob/living/simple_animal/hostile/cult/spear,/turf/open/floor/iron/cult,/area/ruin/lavaland/unpowered)
"Mp" = (/mob/living/simple_animal/hostile/cult,/turf/open/floor/iron/cult,/area/ruin/lavaland/unpowered)
"Mq" = (/obj/effect/decal/cleanable/dirt/dust,/obj/effect/decal/cleanable/dirt/dust,/turf/open/floor/iron/cult,/area/ruin/lavaland/unpowered)
"MW" = (/obj/effect/decal/cleanable/blood/footprints,/turf/open/floor/iron/cult,/area/ruin/lavaland/unpowered)
"Nl" = (/obj/effect/decal/cleanable/blood/tracks{dir = 8},/obj/structure/trap/fire,/turf/open/floor/iron/cult,/area/ruin/lavaland/unpowered)
"Ny" = (/obj/structure/trap/fire,/obj/effect/decal/cleanable/dirt/dust,/turf/open/floor/iron/cult,/area/ruin/lavaland/unpowered)
"NR" = (/obj/effect/rune/narsie{color = "#ff0000"; used = 1; pixel_x = -45; pixel_y = -48},/obj/effect/decal/cleanable/dirt/dust,/turf/open/floor/iron/cult,/area/ruin/lavaland/unpowered)
"NY" = (/obj/effect/decal/cleanable/dirt/dust,/obj/effect/decal/cleanable/cobweb,/turf/open/floor/iron/cult,/area/ruin/lavaland/unpowered)
"Oa" = (/obj/structure/trap/fire,/turf/open/floor/iron/cult,/area/ruin/lavaland/unpowered)
"PC" = (/turf/closed/wall/mineral/abductor,/area/ruin/lavaland/unpowered)
"PP" = (/obj/item/organ/heart,/turf/open/floor/iron/cult,/area/ruin/lavaland/unpowered)
"Qr" = (/obj/item/hemostat/alien,/turf/open/floor/iron/cult,/area/ruin/lavaland/unpowered)
"Rm" = (/obj/effect/decal/cleanable/blood,/obj/item/stack/sheet/runed_metal/ten,/turf/open/floor/iron/cult,/area/ruin/lavaland/unpowered)
"Sy" = (/obj/item/clothing/shoes/cult,/obj/effect/decal/cleanable/dirt/dust,/turf/open/floor/iron/cult,/area/ruin/lavaland/unpowered)
"Tc" = (/obj/effect/mob_spawn/human/corpse/assistant/brainrot_infection,/turf/open/floor/grass/grass0,/area/ruin/lavaland/unpowered)
"TR" = (/mob/living/simple_animal/hostile/cult/mannequin,/turf/open/floor/iron/cult,/area/ruin/lavaland/unpowered)
"TW" = (/obj/item/clothing/head/helmet/abductor,/turf/open/floor/plating/abductor,/area/ruin/lavaland/unpowered)
"TZ" = (/obj/machinery/door/airlock/cult/friendly,/obj/structure/trap/fire,/turf/open/floor/iron/cult,/area/ruin/lavaland/unpowered)
"Uu" = (/obj/structure/trap/cult,/obj/effect/decal/cleanable/dirt/dust,/turf/open/floor/iron/cult,/area/ruin/lavaland/unpowered)
"UV" = (/obj/item/organ/heart/demon,/turf/open/floor/iron/cult,/area/ruin/lavaland/unpowered)
"Ve" = (/obj/structure/table/wood/fancy/royalblack,/turf/open/floor/iron/cult,/area/ruin/lavaland/unpowered)
"Vj" = (/obj/structure/closet/abductor,/turf/open/floor/plating/abductor,/area/ruin/lavaland/unpowered)
"VB" = (/obj/effect/decal/cleanable/blood,/obj/effect/decal/cleanable/dirt/dust,/turf/open/floor/iron/cult,/area/ruin/lavaland/unpowered)
"VF" = (/obj/effect/decal/cleanable/blood/gibs/human/down,/turf/open/floor/iron/cult,/area/ruin/lavaland/unpowered)
"Wm" = (/obj/effect/mob_spawn/human/corpse/assistant/beesease_infection,/obj/effect/decal/cleanable/dirt/dust,/turf/open/floor/iron/cult,/area/ruin/lavaland/unpowered)
"Wv" = (/obj/effect/decal/cleanable/dirt/dust,/obj/item/stack/spacecash/c10000,/turf/open/floor/iron/cult,/area/ruin/lavaland/unpowered)
"Ww" = (/mob/living/simple_animal/hostile/cult/horror,/turf/open/floor/iron/cult,/area/ruin/lavaland/unpowered)
"WN" = (/obj/item/surgicaldrill/alien,/turf/open/floor/iron/cult,/area/ruin/lavaland/unpowered)
"WT" = (/obj/effect/decal/cleanable/generic,/turf/open/floor/iron/cult,/area/ruin/lavaland/unpowered)
"Xo" = (/obj/structure/trap/cult,/turf/open/floor/iron/cult,/area/ruin/lavaland/unpowered)
"XJ" = (/turf/template_noop,/area/template_noop)
"YQ" = (/turf/open/floor/plating/abductor,/area/ruin/lavaland/unpowered)
"YR" = (/mob/living/simple_animal/hostile/cult/magic,/turf/open/floor/iron/cult,/area/ruin/lavaland/unpowered)
"Zj" = (/turf/open/floor/grass/grass0,/area/ruin/lavaland/unpowered)
"Zr" = (/obj/effect/decal/cleanable/blood/old,/obj/effect/decal/cleanable/dirt/dust,/turf/open/floor/iron/cult,/area/ruin/lavaland/unpowered)

(1,1,1) = {"
XJXJXJXJXJXJXJXJXJXJXJXJXJXJXJXJXJXJXJIPIPXJXJXJXJXJXJXJXJXJXJXJXJXJXJXJXJXJXJXJ
XJXJXJXJXJXJXJXJXJXJXJXJXJXJXJXJXJXJXJIPIPIPXJXJXJXJXJXJXJXJXJXJXJXJXJXJXJXJXJXJ
XJXJXJXJIPIPIPIPIPXJXJXJXJXJXJXJXJXJXJIPmMIPIPXJXJXJXJXJXJXJXJXJXJXJXJXJXJXJXJXJ
XJXJXJIPIPIPIPlpIPIPIPXJXJXJXJXJXJIPIPIPmMIPIPXJXJXJXJXJXJXJXJXJXJXJXJXJXJXJXJXJ
XJXJXJIPIPIPIPIPmMmMIPIPXJXJXJXJIPIPIPIPmMIPEmIPXJXJXJXJXJXJXJXJXJXJXJXJXJXJXJXJ
XJXJXJIPIPIPIPIPmMmMIPIPXJXJXJXJIPIPFHFHmMmMIPIPIPIPXJXJXJXJXJXJXJXJXJXJXJXJXJXJ
XJXJXJIPIPIPIPIPmMmMsJIPIPIPXJIPIPIPFHFHIPmMIPIPIPlpIPXJXJXJXJXJXJXJXJXJXJXJXJXJ
XJXJXJIPIPIPIPIPIPmMmMmMIPIPXJIPsJIPFHFHIPmMIPmMmMfTIPfTIPIPIPIPXJXJXJXJXJXJXJXJ
XJXJXJIPIPIPIPIPsJmMmMmMIPIPIPIPIPIPFHFHmMmMmMmMfTfTyjfTfTfTfTfTfTfTXJXJXJXJXJXJ
XJXJXJXJIPIPIPIPIPmMmMsJmMIPsJIPmMmMmMFHFHmMvhmMfTsJsJsJsJsJsJhnsJXJXJXJXJXJXJXJ
XJXJXJXJXJIPIPYQPCPCPCPCPCmMmMmMmMmMFHFHFHmMmMmMfTsJfTfTfTfTfTfTsJsJXJXJXJXJXJXJ
XJXJXJXJXJIPsJPCPCRmTWYQPCPCfTfTfTfTfTfTfTfTfTfTfTsJdEsJfTsJsJFBsJsJXJXJXJXJXJXJ
XJXJXJXJXJsJIPPCYQcmVjFBYQQrfTUVaNfTsJFHFHfTsJMpfTxQsJsJfTgmfTfTfTfTfTfTXJXJXJXJ
XJXJXJXJXJXJIPPCDyYQYRBIYQsJfTsJVBfTsJFHFHfTsJozfTfTfTCpfTsJfTsJsJCpsJXJXJXJXJXJ
XJXJXJXJXJIPIPPCsJLrLrLrLrsJvrCpCpfTsJsJFHfTsJvrsJsJfTCpfTsJfTFKfTfTfTfTfTfTXJXJ
XJXJXJXJXJIPIPsJsJYQYQhCZjhPsJkRsJsJfEsJFHfTFHFBsJsJfTZrfTsJfTCpfTIPXJXJXJXJXJXJ
XJIPIPIPsJIPIPXosJWNLiJBsJFyfTsJXobRfTsJFHFHvrFHvrsJfTCpfTsJfTCpfTIPXJXJXJXJXJXJ
IPIPIPmMmMmMmMmMfTfTfTfTfTfTfTzmsJsJfTfTFHFHfTfTfTfTfTMqfTDAfTUufTIPXJXJXJXJXJXJ
IPIPIPmMmMmMsJmMwQbCfTossJyjcuvrsJFHfTFHFHFHJIsJhCZjfTMqsJPPfTCpfTIPXJXJXJXJXJXJ
XJXJIPIPIPIPbCbCbCbCfTYRUuyjsJvrFHFHfTfTFHFHyjXosJGKfTMqfTfTfTCpfTIPXJXJXJXJXJXJ
XJXJIPIPIPIPIPIPsIbCfTEZCpfTJYvrsJsJfTfTFHFHfTfTpZHAfTMqHKsJsJCpfTmMXJXJXJXJXJXJ
XJXJXJIPEmIPIPIPqObCfTWmsJfTossJXolffTfTfTFHFHfTfTfTfTCpsJzZgmsJfTmMXJXJXJmMmMmM
XJXJXJIPIPIPIPIPbCbCfTCpWTfTfTfTfTfTfTfTfTFHFHKrTcZjfTCpfTfTfTfTfTfTmMmMmMmMXJXJ
XJXJXJXJXJXJIPIPbCbCfTKrKrfTscLisJmwsJhmfTFHFHKrbZftfTCpfTLihnsJaNfTXJXJXJXJXJXJ
XJXJXJXJXJXJIPIPbCbCfThvsJfTTRAYCpszCpNyfTfTfTfTfTfTfTsJfTsJCpCpMgfTXJXJXJXJXJXJ
XJXJXJXJXJXJXJIPbCbCfTsJsJfTbRsJsJktqrCpfTsJmFfTsJJYsJsJfTUuCpvMsJfTXJXJXJXJXJXJ
tDtDtDtDtDtDtDtDtDtDfTgmsJfTfTsJOamICplZfTFBsJfTsJfTfTfTfTsJrPsJcdfTXJXJXJXJXJXJ
tDfTfTfTfTfTfTfTfTfTfTsJHKsJJIsJCpKhsJsJfTsJsJfTvrvrgfsJsJDACpsJcdfTXJXJXJXJXJXJ
tDfTsJsJsJsJsJsJsJsJfTdcsJsJTZossJsJJzTRfTMWdcfTfTfTfTfTfTfTfTfTVFfTXJXJXJXJXJXJ
tDfTXosJsJsJsJsJsJxWfTfTfTfTfTfTfTfTfTfTfTsJsJDATRFBsJsJsJossJsJsJfTXJXJXJXJXJXJ
tDfTigsJosCpMqsJsJsJfTsJhvlGNllGlGlGVFWwfTsJfTfTfTfTfTfTfTfTfTfTfTfTXJXJXJXJXJXJ
tDfTMgfssJCpNysJgmsJfTfTJIfTfTfTfTfTfTsJfTsJfTFHmMmMmMxqmMXJXJXJXJXJXJXJXJXJXJXJ
tDfTsJsJzZjyLisJsJHNfTNYCpsJhkfTXJXJfTsJsJhnfTFHFHmMmMmMmMXJXJXJXJXJXJXJXJXJXJXJ
tDfTHNsJLiMqsJLisJMgfTlfKmCpVefTXJXJfTfTfTfTfTFHFHmMmMvhmMXJXJXJXJXJXJXJXJXJXJXJ
tDfTxWIhwfadNRsJLisJJIsJsJCpVefTXJXJXJXJXJXJmMFHFHxqmMmMmMXJXJXJXJXJXJXJXJXJXJXJ
tDfTHNLisJsJsJCpLiMgfTlfIuSyVefTXJXJXJXJXJXJmMFHFHFHmMXJXJXJXJXJXJXJXJXJXJXJXJXJ
tDfTsJsJLiWTMqLiFBHNfTFBVBsJVefTXJXJXJXJXJXJmMFHFHFHmMXJXJXJXJXJXJXJXJXJXJXJXJXJ
tDfTMgsHsJFlLisJsJsJfTfTfTfTfTfTXJXJXJXJXJXJmMFHFHFHmMXJXJXJXJXJXJXJXJXJXJXJXJXJ
tDfTWvCpCpsJKuCpsJsJfTtDXJXJXJXJXJXJXJXJXJXJmMmMmMFHmMXJXJXJXJXJXJXJXJXJXJXJXJXJ
tDfTCpsJossJsJsJCpsJfTtDXJXJXJXJXJXJXJXJXJXJmMmMmMmMxqXJXJXJXJXJXJXJXJXJXJXJXJXJ
tDfTCpsJXosJsJsJsJxWfTtDXJXJXJXJXJXJXJXJXJXJXJmMmMXJXJXJXJXJXJXJXJXJXJXJXJXJXJXJ
tDfTsJsJsJsJsJsJsJsJfTtDXJXJXJXJXJXJXJXJXJXJXJXJXJXJXJXJXJXJXJXJXJXJXJXJXJXJXJXJ
tDfTfTfTfTfTfTfTfTfTfTtDXJXJXJXJXJXJXJXJXJXJXJXJXJXJXJXJXJXJXJXJXJXJXJXJXJXJXJXJ
tDtDtDtDtDtDtDtDtDtDtDtDXJXJXJXJXJXJXJXJXJXJXJXJXJXJXJXJXJXJXJXJXJXJXJXJXJXJXJXJ
"}
