//MAP CONVERTED BY dmm2tgm.py THIS HEADER COMMENT PREVENTS RECONVERSION, DO NOT REMOVE
"aj" = (
/obj/item/wallframe/airalarm,
/turf/open/floor/plasteel/airless,
/area/awaymission/challenge)
"bp" = (
/obj/structure/cable{
	icon_state = "1-8"
	},
/turf/open/floor/plating/asteroid/basalt/lava_land_surface,
/area/lavaland/surface/outdoors)
"bv" = (
/obj/machinery/atmospherics/pipe/simple/cyan/visible/layer1{
	dir = 4
	},
/turf/open/floor/plating/asteroid/basalt/lava_land_surface,
/area/awaymission/challenge)
"ch" = (
/turf/closed/wall,
/area/lavaland/surface/outdoors)
"cj" = (
/obj/structure/cable{
	icon_state = "4-8"
	},
/obj/machinery/door/airlock/atmos/glass,
/turf/open/floor/plasteel/airless,
/area/awaymission/challenge)
"cZ" = (
/obj/item/storage/bag/ore,
/turf/open/floor/plating/asteroid/basalt/lava_land_surface,
/area/lavaland/surface/outdoors)
"dw" = (
/obj/item/pickaxe,
/obj/item/mining_scanner,
/turf/open/floor/plating/asteroid/basalt/lava_land_surface,
/area/lavaland/surface/outdoors)
"dA" = (
/obj/machinery/power/smes,
/obj/structure/cable{
	icon_state = "0-4"
	},
/turf/open/floor/plating/asteroid/basalt/lava_land_surface,
/area/awaymission/challenge)
"dV" = (
/obj/item/wallframe/apc,
/obj/structure/cable{
	icon_state = "0-8"
	},
/turf/open/floor/plating/asteroid/basalt/lava_land_surface,
/area/awaymission/challenge)
"eP" = (
/obj/item/stack/cable_coil/cut,
/obj/effect/decal/cleanable/dirt/dust,
/turf/open/floor/plasteel/airless,
/area/awaymission/challenge)
"fi" = (
/obj/structure/cable{
	icon_state = "1-2"
	},
/obj/item/stock_parts/cell,
/turf/open/floor/plating/asteroid/basalt/lava_land_surface,
/area/awaymission/challenge)
"gd" = (
/obj/structure/frame/machine,
/turf/open/floor/plating/asteroid/basalt/lava_land_surface,
/area/awaymission/challenge)
"gy" = (
/obj/item/tank/internals/oxygen,
/obj/item/clothing/mask/breath,
/turf/open/floor/plasteel/airless{
	icon_state = "damaged5"
	},
/area/awaymission/challenge)
"ha" = (
/turf/open/floor/plating/asteroid/basalt/lava_land_surface,
/area/lavaland/surface/outdoors)
"ig" = (
/obj/structure/cable{
	icon_state = "1-8"
	},
/obj/structure/cable{
	icon_state = "2-8"
	},
/turf/open/floor/plasteel/airless{
	icon_state = "damaged1"
	},
/area/awaymission/challenge)
"ir" = (
/obj/effect/mob_spawn/human/wandering_hermit,
/turf/open/floor/plasteel/airless,
/area/awaymission/challenge)
"iS" = (
/obj/structure/cable{
	icon_state = "4-8"
	},
/turf/open/floor/plasteel/airless{
	icon_state = "damaged2"
	},
/area/awaymission/challenge)
"jK" = (
/obj/effect/decal/cleanable/dirt/dust,
/turf/open/floor/plasteel/airless,
/area/awaymission/challenge)
"jO" = (
/obj/structure/window/reinforced/spawner/west,
/obj/structure/window/reinforced/spawner,
/obj/effect/mapping_helpers/no_lava,
/turf/open/floor/plating/asteroid/basalt/lava_land_surface,
/area/awaymission/challenge)
"kA" = (
/obj/machinery/computer/rdconsole/production{
	dir = 4
	},
/obj/item/stack/sheet/mineral/plasma,
/turf/open/floor/plating/asteroid/basalt/lava_land_surface,
/area/awaymission/challenge)
"lA" = (
/turf/open/floor/plasteel/airless{
	icon_state = "damaged1"
	},
/area/awaymission/challenge)
"lC" = (
/obj/item/stock_parts/cell,
/turf/open/floor/plating/asteroid/basalt/lava_land_surface,
/area/awaymission/challenge)
"mp" = (
/obj/structure/cable{
	icon_state = "2-8"
	},
/turf/open/floor/plasteel/airless,
/area/awaymission/challenge)
"nu" = (
/obj/structure/cable{
	icon_state = "1-2"
	},
/obj/structure/cable{
	icon_state = "2-4"
	},
/obj/effect/decal/cleanable/dirt/dust,
/turf/open/floor/plating/asteroid/basalt/lava_land_surface,
/area/awaymission/challenge)
"nz" = (
/obj/structure/grille,
/turf/open/floor/plasteel/airless,
/area/awaymission/challenge)
"oN" = (
/obj/structure/cable{
	icon_state = "1-2"
	},
/turf/open/floor/plasteel/airless,
/area/awaymission/challenge)
"pE" = (
/obj/item/vending_refill/kink,
/obj/effect/decal/cleanable/semen,
/turf/open/floor/plating/asteroid/basalt/lava_land_surface,
/area/awaymission/challenge)
"rp" = (
/obj/machinery/door/airlock/research/glass,
/obj/structure/cable{
	icon_state = "1-2"
	},
/turf/open/floor/plating/asteroid/basalt/lava_land_surface,
/area/awaymission/challenge)
"rR" = (
/obj/item/storage/toolbox/mechanical,
/turf/open/floor/plating/asteroid/basalt/lava_land_surface,
/area/awaymission/challenge)
"ss" = (
/obj/item/stock_parts/cell,
/turf/open/floor/plasteel/airless,
/area/awaymission/challenge)
"ue" = (
/obj/machinery/ore_silo,
/obj/item/stack/sheet/mineral/diamond{
	amount = 5
	},
/turf/open/floor/plasteel/airless,
/area/awaymission/challenge)
"uP" = (
/obj/structure/grille,
/obj/structure/window/reinforced/fulltile,
/turf/open/floor/plasteel/airless,
/area/awaymission/challenge)
"vj" = (
/obj/structure/cable{
	icon_state = "4-8"
	},
/obj/effect/decal/cleanable/dirt/dust,
/turf/open/floor/plasteel/airless,
/area/awaymission/challenge)
"vC" = (
/turf/open/floor/plasteel/airless{
	icon_state = "damaged2"
	},
/area/awaymission/challenge)
"wd" = (
/obj/structure/frame/machine,
/turf/open/floor/plasteel/airless,
/area/awaymission/challenge)
"wj" = (
/obj/structure/cable{
	icon_state = "0-8"
	},
/obj/structure/cable{
	icon_state = "2-4"
	},
/obj/item/clothing/mask/breath,
/turf/open/floor/plating/asteroid/basalt/lava_land_surface,
/area/awaymission/challenge)
"wk" = (
/obj/item/stack/sheet/metal/ten,
/obj/effect/decal/cleanable/dirt/dust,
/turf/open/floor/plasteel/airless,
/area/awaymission/challenge)
"wF" = (
/obj/item/circuitboard/machine/mining_equipment_vendor/golem,
/turf/open/floor/plating/asteroid/basalt/lava_land_surface,
/area/awaymission/challenge)
"yv" = (
/obj/structure/window/reinforced/spawner,
/obj/machinery/atmospherics/components/unary/outlet_injector/layer1,
/obj/effect/mapping_helpers/no_lava,
/turf/open/floor/plating/asteroid/basalt/lava_land_surface,
/area/awaymission/challenge)
"zr" = (
/turf/closed/wall,
/area/awaymission/challenge)
"zu" = (
/obj/structure/cable,
/obj/item/stack/sheet/metal/ten,
/turf/open/floor/plasteel/airless,
/area/awaymission/challenge)
"AW" = (
/obj/structure/window/reinforced/spawner,
/obj/structure/window/reinforced/spawner/east,
/obj/machinery/atmospherics/components/unary/vent_scrubber/layer3,
/obj/effect/mapping_helpers/no_lava,
/turf/open/floor/plating/asteroid/basalt/lava_land_surface,
/area/awaymission/challenge)
"Br" = (
/obj/item/stack/cable_coil/cut,
/turf/open/floor/plating/asteroid/basalt/lava_land_surface,
/area/awaymission/challenge)
"BX" = (
/obj/item/wallframe/airalarm,
/turf/open/floor/plating/asteroid/basalt/lava_land_surface,
/area/awaymission/challenge)
"Cj" = (
/obj/machinery/mineral/ore_redemption,
/turf/open/floor/plating/asteroid/basalt/lava_land_surface,
/area/lavaland/surface/outdoors)
"CD" = (
/obj/item/card/id/mining,
/turf/open/floor/plasteel/airless,
/area/awaymission/challenge)
"CL" = (
/obj/structure/cable,
/obj/effect/mapping_helpers/no_lava,
/turf/open/floor/plating/asteroid/basalt/lava_land_surface,
/area/lavaland/surface/outdoors)
"CV" = (
/obj/machinery/door/airlock/external/glass,
/turf/open/floor/plasteel/airless,
/area/lavaland/surface/outdoors)
"CX" = (
/obj/effect/mob_spawn/human/wandering_hermit,
/turf/open/floor/plating/asteroid/basalt/lava_land_surface,
/area/awaymission/challenge)
"Dr" = (
/obj/item/tank/internals/oxygen,
/turf/open/floor/plasteel/airless{
	icon_state = "damaged2"
	},
/area/awaymission/challenge)
"Dz" = (
/obj/effect/mapping_helpers/no_lava,
/obj/effect/mapping_helpers/no_lava,
/turf/open/floor/plating/asteroid/basalt/lava_land_surface,
/area/lavaland/surface/outdoors)
"ER" = (
/obj/structure/window/reinforced/spawner/east,
/obj/structure/window/reinforced/spawner,
/obj/machinery/atmospherics/components/unary/vent_scrubber/layer1{
	anchored = 0;
	dir = 8
	},
/obj/effect/mapping_helpers/no_lava,
/obj/item/pipe_dispenser,
/turf/open/floor/plating/asteroid/basalt/lava_land_surface,
/area/awaymission/challenge)
"FA" = (
/obj/item/stack/sheet/mineral/plasma,
/turf/open/floor/plating/asteroid/basalt/lava_land_surface,
/area/awaymission/challenge)
"FM" = (
/obj/item/stack/rods,
/turf/open/floor/plating/asteroid/basalt/lava_land_surface,
/area/lavaland/surface/outdoors)
"FZ" = (
/obj/item/stack/cable_coil/red,
/obj/effect/decal/cleanable/dirt/dust,
/turf/open/floor/plasteel/airless,
/area/awaymission/challenge)
"GU" = (
/obj/structure/cable,
/turf/open/floor/plating/asteroid/basalt/lava_land_surface,
/area/awaymission/challenge)
"HK" = (
/obj/structure/frame/machine,
/obj/item/circuitboard/machine/autolathe,
/turf/open/floor/plating/asteroid/basalt/lava_land_surface,
/area/awaymission/challenge)
"II" = (
/obj/structure/cable{
	icon_state = "1-4"
	},
/turf/open/floor/plating/asteroid/basalt/lava_land_surface,
/area/awaymission/challenge)
"IK" = (
/obj/structure/cable{
	icon_state = "2-4"
	},
/turf/open/floor/plating/asteroid/basalt/lava_land_surface,
/area/awaymission/challenge)
"Jb" = (
/obj/machinery/atmospherics/pipe/simple/brown/visible/layer1{
	dir = 5
	},
/turf/open/floor/plating/asteroid/basalt/lava_land_surface,
/area/awaymission/challenge)
"Jt" = (
/obj/structure/cable{
	icon_state = "0-4"
	},
/turf/open/floor/plating/asteroid/basalt/lava_land_surface,
/area/awaymission/challenge)
"Kl" = (
/obj/item/circuitboard/machine/pacman,
/obj/structure/cable{
	icon_state = "0-2"
	},
/obj/structure/frame/machine,
/obj/item/stock_parts/micro_laser/high,
/obj/item/stock_parts/matter_bin/adv,
/turf/open/floor/plasteel/airless,
/area/awaymission/challenge)
"Ku" = (
/obj/item/wallframe/apc,
/obj/structure/frame/machine,
/turf/open/floor/plasteel/airless,
/area/awaymission/challenge)
"KS" = (
/obj/structure/cable{
	icon_state = "1-2"
	},
/turf/open/floor/plating/asteroid/basalt/lava_land_surface,
/area/awaymission/challenge)
"Le" = (
/obj/structure/cable{
	icon_state = "4-8"
	},
/obj/item/crowbar,
/turf/open/floor/plasteel/airless,
/area/awaymission/challenge)
"LC" = (
/turf/open/floor/plating/asteroid/basalt/lava_land_surface,
/area/awaymission/challenge)
"Nq" = (
/turf/open/floor/plasteel/airless,
/area/awaymission/challenge)
"Pm" = (
/obj/structure/girder,
/turf/open/floor/plating/asteroid/basalt/lava_land_surface,
/area/lavaland/surface/outdoors)
"PW" = (
/turf/open/floor/plasteel/airless{
	icon_state = "damaged3"
	},
/area/awaymission/challenge)
"Qn" = (
/obj/effect/mapping_helpers/no_lava,
/turf/open/floor/plating/asteroid/basalt/lava_land_surface,
/area/lavaland/surface/outdoors)
"QN" = (
/obj/structure/cable{
	icon_state = "4-8"
	},
/turf/open/floor/plating/asteroid/basalt/lava_land_surface,
/area/awaymission/challenge)
"QQ" = (
/turf/closed/mineral/volcanic/lava_land_surface,
/area/lavaland/surface/outdoors)
"QR" = (
/obj/item/electronics/apc,
/obj/item/electronics/apc,
/obj/item/electronics/apc,
/obj/item/electronics/apc,
/obj/item/wallframe/apc,
/obj/item/wallframe/apc,
/obj/item/wallframe/apc,
/obj/item/electronics/airalarm,
/obj/item/electronics/airalarm,
/obj/item/electronics/airalarm,
/obj/item/electronics/airalarm,
/obj/item/electronics/airalarm,
/obj/structure/closet/crate,
/obj/item/circuitboard/machine/vendor,
/turf/open/floor/plasteel/airless,
/area/awaymission/challenge)
"QT" = (
/turf/open/floor/plasteel/airless{
	icon_state = "damaged4"
	},
/area/awaymission/challenge)
"SS" = (
/obj/machinery/atmospherics/pipe/simple/cyan/visible/layer1{
	dir = 9
	},
/turf/open/floor/plating/asteroid/basalt/lava_land_surface,
/area/awaymission/challenge)
"SU" = (
/obj/structure/cable{
	icon_state = "0-4"
	},
/obj/item/stack/cable_coil/cut,
/turf/open/floor/plating/asteroid/basalt/lava_land_surface,
/area/awaymission/challenge)
"Ta" = (
/obj/item/stack/rods,
/turf/open/floor/plating/asteroid/basalt/lava_land_surface,
/area/awaymission/challenge)
"Tu" = (
/obj/structure/cable,
/obj/item/stock_parts/capacitor/adv,
/turf/open/floor/plating/asteroid/basalt/lava_land_surface,
/area/awaymission/challenge)
"Tz" = (
/turf/template_noop,
/area/template_noop)
"UA" = (
/obj/structure/girder,
/turf/open/floor/plating/asteroid/basalt/lava_land_surface,
/area/awaymission/challenge)
"UD" = (
/obj/structure/cable{
	icon_state = "0-8"
	},
/turf/open/floor/plating/asteroid/basalt/lava_land_surface,
/area/awaymission/challenge)
"UE" = (
/obj/machinery/door/airlock/glass,
/turf/open/floor/plasteel/airless,
/area/awaymission/challenge)
"UK" = (
/obj/machinery/door/airlock/public/glass,
/obj/structure/cable{
	icon_state = "1-2"
	},
/turf/open/floor/plasteel/airless,
/area/awaymission/challenge)
"VT" = (
/obj/item/card/id/mining,
/turf/open/floor/plating/asteroid/basalt/lava_land_surface,
/area/awaymission/challenge)
"We" = (
/obj/machinery/atmospherics/components/trinary/mixer/flipped/layer1{
	dir = 8
	},
/obj/machinery/atmospherics/pipe/simple/brown/visible/layer1,
/obj/machinery/atmospherics/pipe/simple/cyan/visible/layer1{
	dir = 4
	},
/turf/open/floor/plating/asteroid/basalt/lava_land_surface,
/area/awaymission/challenge)
"Yl" = (
/obj/effect/decal/cleanable/semendrip,
/turf/open/floor/plasteel/airless,
/area/awaymission/challenge)
"Yt" = (
/obj/structure/cable{
	icon_state = "0-4"
	},
/obj/effect/decal/cleanable/dirt/dust,
/turf/open/floor/plating/asteroid/basalt/lava_land_surface,
/area/awaymission/challenge)
"ZP" = (
/obj/structure/cable{
	icon_state = "4-8"
	},
/turf/open/floor/plasteel/airless,
/area/awaymission/challenge)

(1,1,1) = {"
Tz
Tz
Tz
Tz
Tz
Tz
Tz
Tz
Tz
Tz
Tz
Tz
Tz
Tz
Tz
Tz
"}
(2,1,1) = {"
Tz
Tz
QQ
QQ
QQ
QQ
QQ
QQ
QQ
Tz
Tz
Tz
Tz
Tz
Tz
Tz
"}
(3,1,1) = {"
Tz
QQ
QQ
UA
UA
zr
zr
zr
Qn
QQ
QQ
QQ
Tz
Tz
Tz
Tz
"}
(4,1,1) = {"
QQ
QQ
ha
UA
LC
II
QR
UA
Qn
Qn
Qn
QQ
QQ
Tz
Tz
Tz
"}
(5,1,1) = {"
QQ
QQ
Qn
zr
BX
iS
BX
UA
Qn
Qn
Qn
ha
QQ
QQ
Tz
Tz
"}
(6,1,1) = {"
QQ
Qn
Qn
zr
ir
QN
CX
UA
Qn
Qn
Qn
ha
ha
QQ
QQ
Tz
"}
(7,1,1) = {"
QQ
Qn
Qn
zr
ss
Le
Ta
zr
Qn
Qn
Qn
Qn
ha
QQ
QQ
Tz
"}
(8,1,1) = {"
QQ
Qn
Qn
UE
FA
wj
oN
UK
CL
Qn
Qn
Qn
Qn
ha
QQ
QQ
"}
(9,1,1) = {"
ha
Qn
Dz
zr
Dr
SU
wk
zr
Qn
Qn
Qn
Qn
Dz
Qn
QQ
QQ
"}
(10,1,1) = {"
ha
FM
Qn
UA
UA
cj
zr
zr
zr
zr
zr
UA
Qn
Qn
ha
QQ
"}
(11,1,1) = {"
QQ
ha
Qn
UA
LC
QN
gy
zr
Kl
zu
dA
zr
Qn
Qn
Qn
QQ
"}
(12,1,1) = {"
QQ
ha
Qn
zr
LC
mp
nu
KS
fi
Tu
dV
zr
Qn
Qn
Qn
Qn
"}
(13,1,1) = {"
ha
Qn
Qn
uP
jO
Jb
UD
zr
zr
UA
zr
zr
zr
zr
zr
Qn
"}
(14,1,1) = {"
QQ
Qn
Qn
nz
ER
We
Br
zr
gd
kA
FZ
zr
lA
ue
zr
Qn
"}
(15,1,1) = {"
QQ
Qn
Qn
zr
aj
bv
Yt
UA
rR
VT
pE
UA
Br
Nq
UA
Qn
"}
(16,1,1) = {"
QQ
Qn
Dz
uP
yv
SS
QN
zr
zr
Yl
zr
UA
lC
lA
UA
Qn
"}
(17,1,1) = {"
QQ
Qn
Qn
uP
AW
IK
ig
rp
GU
Br
HK
gd
LC
LC
zr
Qn
"}
(18,1,1) = {"
QQ
QQ
Qn
zr
LC
Jt
CD
UA
jK
QT
jK
Nq
LC
Ku
zr
Qn
"}
(19,1,1) = {"
QQ
QQ
QQ
zr
wF
vj
PW
zr
aj
wd
vC
LC
Br
eP
zr
Qn
"}
(20,1,1) = {"
Tz
QQ
QQ
zr
zr
ZP
zr
zr
zr
zr
zr
UA
UA
zr
zr
Qn
"}
(21,1,1) = {"
QQ
QQ
QQ
ch
dw
bp
cZ
ha
ha
Qn
Qn
Qn
Qn
Qn
Qn
Qn
"}
(22,1,1) = {"
QQ
QQ
ha
ha
Cj
ha
Pm
ha
ha
Qn
Qn
QQ
QQ
Qn
Qn
QQ
"}
(23,1,1) = {"
QQ
ha
Qn
Pm
ha
ha
Pm
Qn
Qn
Qn
Dz
Dz
Dz
Qn
QQ
QQ
"}
(24,1,1) = {"
QQ
ha
Qn
Pm
ha
CV
Qn
Qn
Qn
QQ
Qn
ha
ha
QQ
QQ
QQ
"}
(25,1,1) = {"
QQ
ha
Qn
Dz
Qn
Qn
Dz
Qn
Qn
Qn
ha
QQ
QQ
QQ
QQ
QQ
"}
(26,1,1) = {"
ha
ha
ha
Qn
Qn
Qn
Dz
Qn
Qn
Qn
QQ
QQ
QQ
QQ
QQ
QQ
"}
