//MAP CONVERTED BY dmm2tgm.py THIS HEADER COMMENT PREVENTS RECONVERSION, DO NOT REMOVE
"bO" = (
/obj/item/clockwork/component/vanguard_cogwheel,
/obj/item/clockwork/component/geis_capacitor/fallen_armor,
/obj/item/stock_parts/micro_laser/ansible,
/obj/item/stock_parts/micro_laser/ansible,
/obj/item/stock_parts/manipulator/zepto,
/obj/structure/table/reinforced/brass,
/turf/open/floor/clockwork/reebe,
/area/ruin/space/has_grav/powered/clockworkhaven)
"bR" = (
/obj/effect/spawner/structure/window/clockwork,
/turf/open/floor/clockwork/reebe,
/area/ruin/space/has_grav/powered/clockworkhaven)
"fi" = (
/obj/structure/table/reinforced/brass,
/obj/item/crowbar/brass,
/obj/item/wirecutters/brass,
/obj/item/wrench/brass,
/obj/item/weldingtool/experimental/brass,
/obj/item/multitool/advanced/brass,
/turf/open/floor/clockwork/reebe,
/area/ruin/space/has_grav/powered/clockworkhaven)
"gh" = (
/obj/machinery/door/window/clockwork{
	dir = 4
	},
/turf/open/floor/clockwork/reebe,
/area/ruin/space/has_grav/powered/clockworkhaven)
"hL" = (
/obj/structure/furnace/infinite/ratvar,
/turf/open/floor/clockwork/reebe,
/area/ruin/space/has_grav/powered/clockworkhaven)
"hN" = (
/obj/item/clockwork/component/vanguard_cogwheel/onyx_prism,
/obj/effect/temp_visual/ratvar/component,
/obj/item/stock_parts/micro_laser/ansible,
/obj/item/stock_parts/micro_laser/ansible,
/obj/item/stock_parts/manipulator/zepto,
/obj/structure/table/reinforced/brass,
/turf/open/floor/clockwork/reebe,
/area/ruin/space/has_grav/powered/clockworkhaven)
"ja" = (
/obj/item/organ/cyberimp/arm/clockwork/claw,
/obj/effect/temp_visual/ratvar/component/capacitor,
/obj/item/stock_parts/micro_laser/ansible,
/obj/item/stock_parts/matter_bin/replicantmatter,
/obj/structure/table/reinforced/brass,
/turf/open/floor/clockwork/reebe,
/area/ruin/space/has_grav/powered/clockworkhaven)
"jz" = (
/obj/effect/clockwork/sigil/transgression,
/turf/open/floor/clockwork/reebe,
/area/ruin/space/has_grav/powered/clockworkhaven)
"mM" = (
/obj/effect/clockwork/sigil/transgression,
/obj/effect/clockwork/overlay/gateway_glow,
/mob/living/simple_animal/hostile/boss/clockcultistboss{
	spacewalk = 1;
	atmos_requirements = list("min_oxy" = 0, "max_oxy" = 0, "min_tox" = 0, "max_tox" = 1, "min_co2" = 0, "max_co2" = 5, "min_n2" = 0, "max_n2" = 0);
	unsuitable_atmos_damage = 0
	},
/turf/open/floor/clockwork/reebe,
/area/ruin/space/has_grav/powered/clockworkhaven)
"mN" = (
/obj/structure/anvil/obtainable/ratvar,
/turf/open/floor/clockwork/reebe,
/area/ruin/space/has_grav/powered/clockworkhaven)
"oc" = (
/obj/item/clockwork/component/belligerent_eye/lens_gem,
/obj/item/clockwork/component/hierophant_ansible,
/obj/item/clockwork/component/vanguard_cogwheel/onyx_prism,
/obj/item/stock_parts/scanning_module/ocular,
/obj/item/stock_parts/manipulator/zepto,
/obj/structure/table/reinforced/brass,
/turf/open/floor/clockwork/reebe,
/area/ruin/space/has_grav/powered/clockworkhaven)
"pj" = (
/obj/machinery/sleeper/clockwork{
	dir = 1
	},
/turf/open/floor/clockwork/reebe,
/area/ruin/space/has_grav/powered/clockworkhaven)
"pP" = (
/obj/machinery/door/window/clockwork,
/turf/open/floor/clockwork/reebe,
/area/ruin/space/has_grav/powered/clockworkhaven)
"rW" = (
/obj/item/clockwork/component/vanguard_cogwheel,
/obj/item/clockwork/component/geis_capacitor/antennae,
/obj/item/stock_parts/scanning_module/ocular,
/obj/item/stock_parts/manipulator/zepto,
/obj/structure/table/reinforced/brass,
/turf/open/floor/clockwork/reebe,
/area/ruin/space/has_grav/powered/clockworkhaven)
"si" = (
/obj/structure/light_prism{
	icon = 'icons/obj/clockwork_objects.dmi';
	icon_state = "stargazer";
	name = "stargazer";
	desc = "A lantern-shaped generator that produces power when near starlight."
	},
/turf/open/floor/clockwork/reebe,
/area/ruin/space/has_grav/powered/clockworkhaven)
"vh" = (
/obj/item/borg/upgrade/clockwork,
/obj/item/clockwork/component/vanguard_cogwheel/onyx_prism,
/obj/item/stock_parts/micro_laser/ansible,
/obj/item/stock_parts/matter_bin/replicantmatter,
/obj/structure/table/reinforced/brass,
/turf/open/floor/clockwork/reebe,
/area/ruin/space/has_grav/powered/clockworkhaven)
"vO" = (
/obj/structure/destructible/clockwork/ocular_warden,
/turf/open/space/basic,
/area/template_noop)
"vQ" = (
/obj/structure/lattice/clockwork,
/obj/effect/spawner/structure/window/clockwork,
/turf/open/floor/clockwork/reebe,
/area/ruin/space/has_grav/powered/clockworkhaven)
"wE" = (
/obj/effect/temp_visual/ratvar/component/capacitor,
/obj/item/clockwork/component/replicant_alloy/smashed_anima_fragment,
/obj/item/stock_parts/scanning_module/ocular,
/obj/item/stock_parts/scanning_module/ocular,
/obj/item/stock_parts/matter_bin/replicantmatter,
/obj/item/stock_parts/manipulator/zepto,
/obj/item/stock_parts/manipulator/zepto,
/obj/item/stock_parts/micro_laser/ansible,
/obj/structure/table/reinforced/brass,
/turf/open/floor/clockwork/reebe,
/area/ruin/space/has_grav/powered/clockworkhaven)
"Ca" = (
/obj/machinery/sleeper/clockwork,
/turf/open/floor/clockwork/reebe,
/area/ruin/space/has_grav/powered/clockworkhaven)
"CZ" = (
/obj/machinery/door/window/clockwork{
	dir = 1
	},
/turf/open/floor/clockwork/reebe,
/area/ruin/space/has_grav/powered/clockworkhaven)
"Dz" = (
/obj/machinery/door/airlock/clockwork/brass,
/turf/open/floor/clockwork/reebe,
/area/ruin/space/has_grav/powered/clockworkhaven)
"Hn" = (
/obj/item/clockwork/component/hierophant_ansible,
/obj/item/clockwork/component/replicant_alloy,
/obj/item/stock_parts/scanning_module/ocular,
/obj/item/stock_parts/scanning_module/ocular,
/obj/item/stock_parts/matter_bin/replicantmatter,
/obj/item/stock_parts/manipulator/zepto,
/obj/item/stock_parts/manipulator/zepto,
/obj/item/stock_parts/micro_laser/ansible,
/obj/structure/table/reinforced/brass,
/turf/open/floor/clockwork/reebe,
/area/ruin/space/has_grav/powered/clockworkhaven)
"IE" = (
/turf/open/space/basic,
/area/template_noop)
"IR" = (
/obj/structure/lattice/clockwork,
/obj/structure/lattice/catwalk/clockwork,
/turf/open/space/basic,
/area/template_noop)
"KK" = (
/obj/machinery/door/window/clockwork{
	dir = 8
	},
/turf/open/floor/clockwork/reebe,
/area/ruin/space/has_grav/powered/clockworkhaven)
"Mm" = (
/obj/structure/lattice/clockwork,
/turf/open/space/basic,
/area/template_noop)
"Ny" = (
/mob/living/simple_animal/hostile/clockwork/clocktank/weak,
/turf/open/floor/clockwork/reebe,
/area/ruin/space/has_grav/powered/clockworkhaven)
"NM" = (
/obj/effect/clockwork/sigil/transgression,
/obj/structure/destructible/clockwork/heralds_beacon,
/turf/open/floor/clockwork/reebe,
/area/ruin/space/has_grav/powered/clockworkhaven)
"NU" = (
/obj/effect/clockwork/sigil/transgression,
/obj/structure/destructible/clockwork/powered/prolonging_prism,
/turf/open/floor/clockwork/reebe,
/area/ruin/space/has_grav/powered/clockworkhaven)
"Os" = (
/obj/structure/destructible/clockwork/powered/mania_motor,
/obj/effect/clockwork/sigil/transgression,
/turf/open/floor/clockwork/reebe,
/area/ruin/space/has_grav/powered/clockworkhaven)
"Rv" = (
/turf/open/floor/clockwork/reebe,
/area/ruin/space/has_grav/powered/clockworkhaven)
"SV" = (
/obj/structure/table/reinforced/brass,
/obj/item/storage/toolbox/brass,
/obj/item/stack/tile/brass/fifty,
/turf/open/floor/clockwork/reebe,
/area/ruin/space/has_grav/powered/clockworkhaven)
"WA" = (
/turf/closed/wall/mineral/bronze,
/area/ruin/space/has_grav/powered/clockworkhaven)

(1,1,1) = {"
IE
IE
IE
IE
IE
IE
IE
bR
WA
Mm
Mm
IE
vO
IE
bR
bR
bR
IE
vO
IE
Mm
Mm
WA
bR
IE
IE
IE
IE
IE
IE
"}
(2,1,1) = {"
IE
IE
IE
IE
IE
IE
bR
si
Rv
bR
IE
Mm
Mm
WA
mN
fi
hL
WA
Mm
Mm
IE
bR
Rv
si
bR
IE
IE
IE
IE
IE
"}
(3,1,1) = {"
IE
IE
IE
IE
IE
bR
Rv
Rv
Rv
bR
IE
IE
bR
Rv
Rv
Rv
Rv
Rv
bR
IE
IE
bR
Rv
Rv
Rv
bR
IE
IE
IE
IE
"}
(4,1,1) = {"
IE
IE
vO
IE
IE
bR
Rv
jz
Rv
bR
IE
IE
bR
Ny
Rv
Os
Rv
Rv
bR
IE
IE
bR
Rv
jz
Rv
bR
IE
IE
vO
IE
"}
(5,1,1) = {"
IE
IE
IE
IE
IE
bR
Rv
Rv
Rv
bR
IR
IE
bR
Rv
Rv
Rv
Rv
Rv
bR
IE
IR
bR
Rv
Rv
Rv
bR
IE
IE
IE
IE
"}
(6,1,1) = {"
IE
IE
IE
IE
bR
si
Rv
Rv
Rv
bR
IR
IR
IE
WA
Rv
Rv
Rv
WA
IE
IR
IR
bR
Rv
Rv
Rv
si
bR
IE
IE
IE
"}
(7,1,1) = {"
IE
IE
IE
IE
bR
Rv
Rv
Rv
bR
IE
IE
IR
IR
IE
bR
Rv
bR
IE
IR
IR
IE
IE
bR
Rv
Rv
Rv
bR
IE
IE
IE
"}
(8,1,1) = {"
IE
IE
IE
IE
bR
Rv
jz
Rv
bR
IE
IE
IE
IR
IR
bR
Rv
bR
IR
IR
IE
IE
IE
bR
Rv
jz
Rv
bR
IE
IE
IE
"}
(9,1,1) = {"
IE
IE
IE
bR
si
Rv
Rv
Rv
WA
Mm
IE
IE
IE
IR
vQ
Rv
vQ
IR
IE
IE
IE
Mm
WA
Rv
Rv
Rv
si
bR
IE
IE
"}
(10,1,1) = {"
IE
IE
IE
bR
Rv
Rv
Rv
bR
IE
Mm
Mm
IE
IE
bR
WA
gh
WA
bR
IE
IE
Mm
IE
IE
bR
Rv
Rv
Rv
bR
IE
IE
"}
(11,1,1) = {"
IE
IE
IE
bR
Rv
Rv
Rv
bR
IE
IE
Mm
Mm
bR
vh
ja
Rv
rW
oc
bR
Mm
Mm
IE
IE
bR
Rv
Rv
Rv
bR
IE
IE
"}
(12,1,1) = {"
IE
IE
WA
si
Rv
Rv
Rv
bR
IE
IE
IE
bR
Rv
Rv
Rv
Rv
Rv
Rv
Rv
bR
IE
IE
IE
bR
Rv
Rv
Rv
si
WA
IE
"}
(13,1,1) = {"
IE
IE
bR
Rv
Rv
Rv
Rv
Dz
Mm
IE
bR
Ca
Rv
jz
Rv
Rv
Rv
jz
Rv
pj
bR
IE
Mm
Dz
Rv
Rv
Rv
Rv
bR
IE
"}
(14,1,1) = {"
IE
IE
bR
Rv
Rv
Rv
Rv
WA
WA
WA
WA
Ca
Rv
Rv
Rv
Rv
Rv
Rv
Rv
pj
WA
WA
WA
WA
Rv
Rv
Rv
Rv
bR
IE
"}
(15,1,1) = {"
IE
IE
bR
si
Rv
NM
Rv
Rv
Rv
Rv
pP
Rv
Rv
Rv
Rv
mM
Rv
Rv
Rv
Rv
CZ
Rv
Rv
Rv
Rv
NU
Rv
si
bR
IE
"}
(16,1,1) = {"
IE
IE
bR
Rv
Rv
Rv
Rv
WA
WA
WA
WA
Ca
Rv
Rv
Rv
Rv
Rv
Rv
Rv
pj
WA
WA
WA
WA
Rv
Rv
Rv
Rv
bR
IE
"}
(17,1,1) = {"
IE
IE
bR
Rv
Rv
Rv
Rv
Dz
Mm
IE
bR
Ca
Rv
jz
Rv
Rv
Rv
jz
Rv
pj
bR
IE
Mm
Dz
Rv
Rv
Rv
Rv
bR
IE
"}
(18,1,1) = {"
IE
IE
WA
si
Rv
Rv
Rv
bR
IE
IE
IE
bR
Rv
Rv
Rv
Rv
Rv
Rv
Rv
bR
IE
IE
IE
bR
Rv
Rv
Rv
si
WA
IE
"}
(19,1,1) = {"
IE
IE
IE
bR
Rv
Rv
Rv
bR
IE
IE
Mm
Mm
bR
wE
Hn
Rv
hN
bO
bR
Mm
Mm
IE
IE
bR
Rv
Rv
Rv
bR
IE
IE
"}
(20,1,1) = {"
IE
IE
IE
bR
Rv
Rv
Rv
bR
IE
Mm
Mm
IE
IE
bR
WA
KK
WA
bR
IE
IE
Mm
Mm
IE
bR
Rv
Rv
Rv
bR
IE
IE
"}
(21,1,1) = {"
IE
IE
IE
bR
si
Rv
Rv
Rv
WA
Mm
IE
IE
IE
IR
vQ
Rv
vQ
IR
IE
IE
IE
Mm
WA
Rv
Rv
Rv
si
bR
IE
IE
"}
(22,1,1) = {"
IE
IE
IE
IE
bR
Rv
jz
Rv
bR
IE
IE
IE
IR
IR
bR
Rv
bR
IR
IR
IE
IE
IE
bR
Rv
jz
Rv
bR
IE
IE
IE
"}
(23,1,1) = {"
IE
IE
IE
IE
bR
Rv
Rv
Rv
bR
IE
IE
IR
IR
IE
bR
Rv
bR
IE
IR
IR
IE
IE
bR
Rv
Rv
Rv
bR
IE
IE
IE
"}
(24,1,1) = {"
IE
IE
IE
IE
bR
si
Rv
Rv
Rv
bR
IR
IR
IE
WA
Rv
Rv
Rv
WA
IE
IR
IR
bR
Rv
Rv
Rv
si
bR
IE
IE
IE
"}
(25,1,1) = {"
IE
IE
IE
IE
IE
bR
Rv
Rv
Rv
bR
IR
IE
bR
Rv
Rv
Rv
Rv
Rv
bR
IE
IR
bR
Rv
Rv
Rv
bR
IE
IE
IE
IE
"}
(26,1,1) = {"
IE
IE
vO
IE
IE
bR
Rv
jz
Rv
bR
IE
IE
bR
Rv
Rv
Os
Rv
Ny
bR
IE
IE
bR
Rv
jz
Rv
bR
IE
IE
vO
IE
"}
(27,1,1) = {"
IE
IE
IE
IE
IE
bR
Rv
Rv
Rv
bR
IE
IE
bR
Rv
Rv
Rv
Rv
Rv
bR
IE
IE
bR
Rv
Rv
Rv
bR
IE
IE
IE
IE
"}
(28,1,1) = {"
IE
IE
IE
IE
IE
IE
bR
si
Rv
bR
IE
Mm
Mm
WA
mN
SV
hL
WA
Mm
Mm
IE
bR
Rv
si
bR
IE
IE
IE
IE
IE
"}
(29,1,1) = {"
IE
IE
IE
IE
IE
IE
IE
bR
WA
Mm
Mm
IE
vO
IE
bR
bR
bR
IE
vO
IE
Mm
Mm
WA
bR
IE
IE
IE
IE
IE
IE
"}
(30,1,1) = {"
IE
IE
IE
IE
IE
IE
IE
IE
IE
IE
IE
IE
IE
IE
IE
IE
IE
IE
IE
IE
IE
IE
IE
IE
IE
IE
IE
IE
IE
IE
"}
