//MAP CONVERTED BY dmm2tgm.py THIS HEADER COMMENT PREVENTS RECONVERSION, DO NOT REMOVE
"fU" = (
/obj/effect/landmark/stationroom/space/forgottenship,
/turf/template_noop,
/area/template_noop)
"sz" = (
/turf/template_noop,
/area/template_noop)

(1,1,1) = {"
sz
sz
sz
sz
sz
sz
sz
sz
sz
sz
sz
sz
sz
sz
sz
sz
sz
sz
sz
sz
sz
sz
sz
sz
sz
sz
sz
sz
sz
sz
sz
sz
sz
sz
sz
sz
sz
sz
sz
sz
sz
sz
sz
sz
sz
sz
sz
sz
sz
sz
sz
sz
sz
sz
sz
sz
sz
sz
sz
sz
sz
sz
sz
sz
sz
sz
sz
sz
sz
sz
sz
sz
fU
"}
(2,1,1) = {"
sz
sz
sz
sz
sz
sz
sz
sz
sz
sz
sz
sz
sz
sz
sz
sz
sz
sz
sz
sz
sz
sz
sz
sz
sz
sz
sz
sz
sz
sz
sz
sz
sz
sz
sz
sz
sz
sz
sz
sz
sz
sz
sz
sz
sz
sz
sz
sz
sz
sz
sz
sz
sz
sz
sz
sz
sz
sz
sz
sz
sz
sz
sz
sz
sz
sz
sz
sz
sz
sz
sz
sz
sz
"}
(3,1,1) = {"
sz
sz
sz
sz
sz
sz
sz
sz
sz
sz
sz
sz
sz
sz
sz
sz
sz
sz
sz
sz
sz
sz
sz
sz
sz
sz
sz
sz
sz
sz
sz
sz
sz
sz
sz
sz
sz
sz
sz
sz
sz
sz
sz
sz
sz
sz
sz
sz
sz
sz
sz
sz
sz
sz
sz
sz
sz
sz
sz
sz
sz
sz
sz
sz
sz
sz
sz
sz
sz
sz
sz
sz
sz
"}
(4,1,1) = {"
sz
sz
sz
sz
sz
sz
sz
sz
sz
sz
sz
sz
sz
sz
sz
sz
sz
sz
sz
sz
sz
sz
sz
sz
sz
sz
sz
sz
sz
sz
sz
sz
sz
sz
sz
sz
sz
sz
sz
sz
sz
sz
sz
sz
sz
sz
sz
sz
sz
sz
sz
sz
sz
sz
sz
sz
sz
sz
sz
sz
sz
sz
sz
sz
sz
sz
sz
sz
sz
sz
sz
sz
sz
"}
(5,1,1) = {"
sz
sz
sz
sz
sz
sz
sz
sz
sz
sz
sz
sz
sz
sz
sz
sz
sz
sz
sz
sz
sz
sz
sz
sz
sz
sz
sz
sz
sz
sz
sz
sz
sz
sz
sz
sz
sz
sz
sz
sz
sz
sz
sz
sz
sz
sz
sz
sz
sz
sz
sz
sz
sz
sz
sz
sz
sz
sz
sz
sz
sz
sz
sz
sz
sz
sz
sz
sz
sz
sz
sz
sz
sz
"}
(6,1,1) = {"
sz
sz
sz
sz
sz
sz
sz
sz
sz
sz
sz
sz
sz
sz
sz
sz
sz
sz
sz
sz
sz
sz
sz
sz
sz
sz
sz
sz
sz
sz
sz
sz
sz
sz
sz
sz
sz
sz
sz
sz
sz
sz
sz
sz
sz
sz
sz
sz
sz
sz
sz
sz
sz
sz
sz
sz
sz
sz
sz
sz
sz
sz
sz
sz
sz
sz
sz
sz
sz
sz
sz
sz
sz
"}
(7,1,1) = {"
sz
sz
sz
sz
sz
sz
sz
sz
sz
sz
sz
sz
sz
sz
sz
sz
sz
sz
sz
sz
sz
sz
sz
sz
sz
sz
sz
sz
sz
sz
sz
sz
sz
sz
sz
sz
sz
sz
sz
sz
sz
sz
sz
sz
sz
sz
sz
sz
sz
sz
sz
sz
sz
sz
sz
sz
sz
sz
sz
sz
sz
sz
sz
sz
sz
sz
sz
sz
sz
sz
sz
sz
sz
"}
(8,1,1) = {"
sz
sz
sz
sz
sz
sz
sz
sz
sz
sz
sz
sz
sz
sz
sz
sz
sz
sz
sz
sz
sz
sz
sz
sz
sz
sz
sz
sz
sz
sz
sz
sz
sz
sz
sz
sz
sz
sz
sz
sz
sz
sz
sz
sz
sz
sz
sz
sz
sz
sz
sz
sz
sz
sz
sz
sz
sz
sz
sz
sz
sz
sz
sz
sz
sz
sz
sz
sz
sz
sz
sz
sz
sz
"}
(9,1,1) = {"
sz
sz
sz
sz
sz
sz
sz
sz
sz
sz
sz
sz
sz
sz
sz
sz
sz
sz
sz
sz
sz
sz
sz
sz
sz
sz
sz
sz
sz
sz
sz
sz
sz
sz
sz
sz
sz
sz
sz
sz
sz
sz
sz
sz
sz
sz
sz
sz
sz
sz
sz
sz
sz
sz
sz
sz
sz
sz
sz
sz
sz
sz
sz
sz
sz
sz
sz
sz
sz
sz
sz
sz
sz
"}
(10,1,1) = {"
sz
sz
sz
sz
sz
sz
sz
sz
sz
sz
sz
sz
sz
sz
sz
sz
sz
sz
sz
sz
sz
sz
sz
sz
sz
sz
sz
sz
sz
sz
sz
sz
sz
sz
sz
sz
sz
sz
sz
sz
sz
sz
sz
sz
sz
sz
sz
sz
sz
sz
sz
sz
sz
sz
sz
sz
sz
sz
sz
sz
sz
sz
sz
sz
sz
sz
sz
sz
sz
sz
sz
sz
sz
"}
(11,1,1) = {"
sz
sz
sz
sz
sz
sz
sz
sz
sz
sz
sz
sz
sz
sz
sz
sz
sz
sz
sz
sz
sz
sz
sz
sz
sz
sz
sz
sz
sz
sz
sz
sz
sz
sz
sz
sz
sz
sz
sz
sz
sz
sz
sz
sz
sz
sz
sz
sz
sz
sz
sz
sz
sz
sz
sz
sz
sz
sz
sz
sz
sz
sz
sz
sz
sz
sz
sz
sz
sz
sz
sz
sz
sz
"}
(12,1,1) = {"
sz
sz
sz
sz
sz
sz
sz
sz
sz
sz
sz
sz
sz
sz
sz
sz
sz
sz
sz
sz
sz
sz
sz
sz
sz
sz
sz
sz
sz
sz
sz
sz
sz
sz
sz
sz
sz
sz
sz
sz
sz
sz
sz
sz
sz
sz
sz
sz
sz
sz
sz
sz
sz
sz
sz
sz
sz
sz
sz
sz
sz
sz
sz
sz
sz
sz
sz
sz
sz
sz
sz
sz
sz
"}
(13,1,1) = {"
sz
sz
sz
sz
sz
sz
sz
sz
sz
sz
sz
sz
sz
sz
sz
sz
sz
sz
sz
sz
sz
sz
sz
sz
sz
sz
sz
sz
sz
sz
sz
sz
sz
sz
sz
sz
sz
sz
sz
sz
sz
sz
sz
sz
sz
sz
sz
sz
sz
sz
sz
sz
sz
sz
sz
sz
sz
sz
sz
sz
sz
sz
sz
sz
sz
sz
sz
sz
sz
sz
sz
sz
sz
"}
(14,1,1) = {"
sz
sz
sz
sz
sz
sz
sz
sz
sz
sz
sz
sz
sz
sz
sz
sz
sz
sz
sz
sz
sz
sz
sz
sz
sz
sz
sz
sz
sz
sz
sz
sz
sz
sz
sz
sz
sz
sz
sz
sz
sz
sz
sz
sz
sz
sz
sz
sz
sz
sz
sz
sz
sz
sz
sz
sz
sz
sz
sz
sz
sz
sz
sz
sz
sz
sz
sz
sz
sz
sz
sz
sz
sz
"}
(15,1,1) = {"
sz
sz
sz
sz
sz
sz
sz
sz
sz
sz
sz
sz
sz
sz
sz
sz
sz
sz
sz
sz
sz
sz
sz
sz
sz
sz
sz
sz
sz
sz
sz
sz
sz
sz
sz
sz
sz
sz
sz
sz
sz
sz
sz
sz
sz
sz
sz
sz
sz
sz
sz
sz
sz
sz
sz
sz
sz
sz
sz
sz
sz
sz
sz
sz
sz
sz
sz
sz
sz
sz
sz
sz
sz
"}
(16,1,1) = {"
sz
sz
sz
sz
sz
sz
sz
sz
sz
sz
sz
sz
sz
sz
sz
sz
sz
sz
sz
sz
sz
sz
sz
sz
sz
sz
sz
sz
sz
sz
sz
sz
sz
sz
sz
sz
sz
sz
sz
sz
sz
sz
sz
sz
sz
sz
sz
sz
sz
sz
sz
sz
sz
sz
sz
sz
sz
sz
sz
sz
sz
sz
sz
sz
sz
sz
sz
sz
sz
sz
sz
sz
sz
"}
(17,1,1) = {"
sz
sz
sz
sz
sz
sz
sz
sz
sz
sz
sz
sz
sz
sz
sz
sz
sz
sz
sz
sz
sz
sz
sz
sz
sz
sz
sz
sz
sz
sz
sz
sz
sz
sz
sz
sz
sz
sz
sz
sz
sz
sz
sz
sz
sz
sz
sz
sz
sz
sz
sz
sz
sz
sz
sz
sz
sz
sz
sz
sz
sz
sz
sz
sz
sz
sz
sz
sz
sz
sz
sz
sz
sz
"}
(18,1,1) = {"
sz
sz
sz
sz
sz
sz
sz
sz
sz
sz
sz
sz
sz
sz
sz
sz
sz
sz
sz
sz
sz
sz
sz
sz
sz
sz
sz
sz
sz
sz
sz
sz
sz
sz
sz
sz
sz
sz
sz
sz
sz
sz
sz
sz
sz
sz
sz
sz
sz
sz
sz
sz
sz
sz
sz
sz
sz
sz
sz
sz
sz
sz
sz
sz
sz
sz
sz
sz
sz
sz
sz
sz
sz
"}
(19,1,1) = {"
sz
sz
sz
sz
sz
sz
sz
sz
sz
sz
sz
sz
sz
sz
sz
sz
sz
sz
sz
sz
sz
sz
sz
sz
sz
sz
sz
sz
sz
sz
sz
sz
sz
sz
sz
sz
sz
sz
sz
sz
sz
sz
sz
sz
sz
sz
sz
sz
sz
sz
sz
sz
sz
sz
sz
sz
sz
sz
sz
sz
sz
sz
sz
sz
sz
sz
sz
sz
sz
sz
sz
sz
sz
"}
(20,1,1) = {"
sz
sz
sz
sz
sz
sz
sz
sz
sz
sz
sz
sz
sz
sz
sz
sz
sz
sz
sz
sz
sz
sz
sz
sz
sz
sz
sz
sz
sz
sz
sz
sz
sz
sz
sz
sz
sz
sz
sz
sz
sz
sz
sz
sz
sz
sz
sz
sz
sz
sz
sz
sz
sz
sz
sz
sz
sz
sz
sz
sz
sz
sz
sz
sz
sz
sz
sz
sz
sz
sz
sz
sz
sz
"}
(21,1,1) = {"
sz
sz
sz
sz
sz
sz
sz
sz
sz
sz
sz
sz
sz
sz
sz
sz
sz
sz
sz
sz
sz
sz
sz
sz
sz
sz
sz
sz
sz
sz
sz
sz
sz
sz
sz
sz
sz
sz
sz
sz
sz
sz
sz
sz
sz
sz
sz
sz
sz
sz
sz
sz
sz
sz
sz
sz
sz
sz
sz
sz
sz
sz
sz
sz
sz
sz
sz
sz
sz
sz
sz
sz
sz
"}
(22,1,1) = {"
sz
sz
sz
sz
sz
sz
sz
sz
sz
sz
sz
sz
sz
sz
sz
sz
sz
sz
sz
sz
sz
sz
sz
sz
sz
sz
sz
sz
sz
sz
sz
sz
sz
sz
sz
sz
sz
sz
sz
sz
sz
sz
sz
sz
sz
sz
sz
sz
sz
sz
sz
sz
sz
sz
sz
sz
sz
sz
sz
sz
sz
sz
sz
sz
sz
sz
sz
sz
sz
sz
sz
sz
sz
"}
(23,1,1) = {"
sz
sz
sz
sz
sz
sz
sz
sz
sz
sz
sz
sz
sz
sz
sz
sz
sz
sz
sz
sz
sz
sz
sz
sz
sz
sz
sz
sz
sz
sz
sz
sz
sz
sz
sz
sz
sz
sz
sz
sz
sz
sz
sz
sz
sz
sz
sz
sz
sz
sz
sz
sz
sz
sz
sz
sz
sz
sz
sz
sz
sz
sz
sz
sz
sz
sz
sz
sz
sz
sz
sz
sz
sz
"}
(24,1,1) = {"
sz
sz
sz
sz
sz
sz
sz
sz
sz
sz
sz
sz
sz
sz
sz
sz
sz
sz
sz
sz
sz
sz
sz
sz
sz
sz
sz
sz
sz
sz
sz
sz
sz
sz
sz
sz
sz
sz
sz
sz
sz
sz
sz
sz
sz
sz
sz
sz
sz
sz
sz
sz
sz
sz
sz
sz
sz
sz
sz
sz
sz
sz
sz
sz
sz
sz
sz
sz
sz
sz
sz
sz
sz
"}
(25,1,1) = {"
sz
sz
sz
sz
sz
sz
sz
sz
sz
sz
sz
sz
sz
sz
sz
sz
sz
sz
sz
sz
sz
sz
sz
sz
sz
sz
sz
sz
sz
sz
sz
sz
sz
sz
sz
sz
sz
sz
sz
sz
sz
sz
sz
sz
sz
sz
sz
sz
sz
sz
sz
sz
sz
sz
sz
sz
sz
sz
sz
sz
sz
sz
sz
sz
sz
sz
sz
sz
sz
sz
sz
sz
sz
"}
(26,1,1) = {"
sz
sz
sz
sz
sz
sz
sz
sz
sz
sz
sz
sz
sz
sz
sz
sz
sz
sz
sz
sz
sz
sz
sz
sz
sz
sz
sz
sz
sz
sz
sz
sz
sz
sz
sz
sz
sz
sz
sz
sz
sz
sz
sz
sz
sz
sz
sz
sz
sz
sz
sz
sz
sz
sz
sz
sz
sz
sz
sz
sz
sz
sz
sz
sz
sz
sz
sz
sz
sz
sz
sz
sz
sz
"}
(27,1,1) = {"
sz
sz
sz
sz
sz
sz
sz
sz
sz
sz
sz
sz
sz
sz
sz
sz
sz
sz
sz
sz
sz
sz
sz
sz
sz
sz
sz
sz
sz
sz
sz
sz
sz
sz
sz
sz
sz
sz
sz
sz
sz
sz
sz
sz
sz
sz
sz
sz
sz
sz
sz
sz
sz
sz
sz
sz
sz
sz
sz
sz
sz
sz
sz
sz
sz
sz
sz
sz
sz
sz
sz
sz
sz
"}
(28,1,1) = {"
sz
sz
sz
sz
sz
sz
sz
sz
sz
sz
sz
sz
sz
sz
sz
sz
sz
sz
sz
sz
sz
sz
sz
sz
sz
sz
sz
sz
sz
sz
sz
sz
sz
sz
sz
sz
sz
sz
sz
sz
sz
sz
sz
sz
sz
sz
sz
sz
sz
sz
sz
sz
sz
sz
sz
sz
sz
sz
sz
sz
sz
sz
sz
sz
sz
sz
sz
sz
sz
sz
sz
sz
sz
"}
(29,1,1) = {"
sz
sz
sz
sz
sz
sz
sz
sz
sz
sz
sz
sz
sz
sz
sz
sz
sz
sz
sz
sz
sz
sz
sz
sz
sz
sz
sz
sz
sz
sz
sz
sz
sz
sz
sz
sz
sz
sz
sz
sz
sz
sz
sz
sz
sz
sz
sz
sz
sz
sz
sz
sz
sz
sz
sz
sz
sz
sz
sz
sz
sz
sz
sz
sz
sz
sz
sz
sz
sz
sz
sz
sz
sz
"}
(30,1,1) = {"
sz
sz
sz
sz
sz
sz
sz
sz
sz
sz
sz
sz
sz
sz
sz
sz
sz
sz
sz
sz
sz
sz
sz
sz
sz
sz
sz
sz
sz
sz
sz
sz
sz
sz
sz
sz
sz
sz
sz
sz
sz
sz
sz
sz
sz
sz
sz
sz
sz
sz
sz
sz
sz
sz
sz
sz
sz
sz
sz
sz
sz
sz
sz
sz
sz
sz
sz
sz
sz
sz
sz
sz
sz
"}
(31,1,1) = {"
sz
sz
sz
sz
sz
sz
sz
sz
sz
sz
sz
sz
sz
sz
sz
sz
sz
sz
sz
sz
sz
sz
sz
sz
sz
sz
sz
sz
sz
sz
sz
sz
sz
sz
sz
sz
sz
sz
sz
sz
sz
sz
sz
sz
sz
sz
sz
sz
sz
sz
sz
sz
sz
sz
sz
sz
sz
sz
sz
sz
sz
sz
sz
sz
sz
sz
sz
sz
sz
sz
sz
sz
sz
"}
(32,1,1) = {"
sz
sz
sz
sz
sz
sz
sz
sz
sz
sz
sz
sz
sz
sz
sz
sz
sz
sz
sz
sz
sz
sz
sz
sz
sz
sz
sz
sz
sz
sz
sz
sz
sz
sz
sz
sz
sz
sz
sz
sz
sz
sz
sz
sz
sz
sz
sz
sz
sz
sz
sz
sz
sz
sz
sz
sz
sz
sz
sz
sz
sz
sz
sz
sz
sz
sz
sz
sz
sz
sz
sz
sz
sz
"}
(33,1,1) = {"
sz
sz
sz
sz
sz
sz
sz
sz
sz
sz
sz
sz
sz
sz
sz
sz
sz
sz
sz
sz
sz
sz
sz
sz
sz
sz
sz
sz
sz
sz
sz
sz
sz
sz
sz
sz
sz
sz
sz
sz
sz
sz
sz
sz
sz
sz
sz
sz
sz
sz
sz
sz
sz
sz
sz
sz
sz
sz
sz
sz
sz
sz
sz
sz
sz
sz
sz
sz
sz
sz
sz
sz
sz
"}
(34,1,1) = {"
sz
sz
sz
sz
sz
sz
sz
sz
sz
sz
sz
sz
sz
sz
sz
sz
sz
sz
sz
sz
sz
sz
sz
sz
sz
sz
sz
sz
sz
sz
sz
sz
sz
sz
sz
sz
sz
sz
sz
sz
sz
sz
sz
sz
sz
sz
sz
sz
sz
sz
sz
sz
sz
sz
sz
sz
sz
sz
sz
sz
sz
sz
sz
sz
sz
sz
sz
sz
sz
sz
sz
sz
sz
"}
(35,1,1) = {"
sz
sz
sz
sz
sz
sz
sz
sz
sz
sz
sz
sz
sz
sz
sz
sz
sz
sz
sz
sz
sz
sz
sz
sz
sz
sz
sz
sz
sz
sz
sz
sz
sz
sz
sz
sz
sz
sz
sz
sz
sz
sz
sz
sz
sz
sz
sz
sz
sz
sz
sz
sz
sz
sz
sz
sz
sz
sz
sz
sz
sz
sz
sz
sz
sz
sz
sz
sz
sz
sz
sz
sz
sz
"}
(36,1,1) = {"
sz
sz
sz
sz
sz
sz
sz
sz
sz
sz
sz
sz
sz
sz
sz
sz
sz
sz
sz
sz
sz
sz
sz
sz
sz
sz
sz
sz
sz
sz
sz
sz
sz
sz
sz
sz
sz
sz
sz
sz
sz
sz
sz
sz
sz
sz
sz
sz
sz
sz
sz
sz
sz
sz
sz
sz
sz
sz
sz
sz
sz
sz
sz
sz
sz
sz
sz
sz
sz
sz
sz
sz
sz
"}
(37,1,1) = {"
sz
sz
sz
sz
sz
sz
sz
sz
sz
sz
sz
sz
sz
sz
sz
sz
sz
sz
sz
sz
sz
sz
sz
sz
sz
sz
sz
sz
sz
sz
sz
sz
sz
sz
sz
sz
sz
sz
sz
sz
sz
sz
sz
sz
sz
sz
sz
sz
sz
sz
sz
sz
sz
sz
sz
sz
sz
sz
sz
sz
sz
sz
sz
sz
sz
sz
sz
sz
sz
sz
sz
sz
sz
"}
(38,1,1) = {"
sz
sz
sz
sz
sz
sz
sz
sz
sz
sz
sz
sz
sz
sz
sz
sz
sz
sz
sz
sz
sz
sz
sz
sz
sz
sz
sz
sz
sz
sz
sz
sz
sz
sz
sz
sz
sz
sz
sz
sz
sz
sz
sz
sz
sz
sz
sz
sz
sz
sz
sz
sz
sz
sz
sz
sz
sz
sz
sz
sz
sz
sz
sz
sz
sz
sz
sz
sz
sz
sz
sz
sz
sz
"}
(39,1,1) = {"
sz
sz
sz
sz
sz
sz
sz
sz
sz
sz
sz
sz
sz
sz
sz
sz
sz
sz
sz
sz
sz
sz
sz
sz
sz
sz
sz
sz
sz
sz
sz
sz
sz
sz
sz
sz
sz
sz
sz
sz
sz
sz
sz
sz
sz
sz
sz
sz
sz
sz
sz
sz
sz
sz
sz
sz
sz
sz
sz
sz
sz
sz
sz
sz
sz
sz
sz
sz
sz
sz
sz
sz
sz
"}
(40,1,1) = {"
sz
sz
sz
sz
sz
sz
sz
sz
sz
sz
sz
sz
sz
sz
sz
sz
sz
sz
sz
sz
sz
sz
sz
sz
sz
sz
sz
sz
sz
sz
sz
sz
sz
sz
sz
sz
sz
sz
sz
sz
sz
sz
sz
sz
sz
sz
sz
sz
sz
sz
sz
sz
sz
sz
sz
sz
sz
sz
sz
sz
sz
sz
sz
sz
sz
sz
sz
sz
sz
sz
sz
sz
sz
"}
(41,1,1) = {"
sz
sz
sz
sz
sz
sz
sz
sz
sz
sz
sz
sz
sz
sz
sz
sz
sz
sz
sz
sz
sz
sz
sz
sz
sz
sz
sz
sz
sz
sz
sz
sz
sz
sz
sz
sz
sz
sz
sz
sz
sz
sz
sz
sz
sz
sz
sz
sz
sz
sz
sz
sz
sz
sz
sz
sz
sz
sz
sz
sz
sz
sz
sz
sz
sz
sz
sz
sz
sz
sz
sz
sz
sz
"}
(42,1,1) = {"
sz
sz
sz
sz
sz
sz
sz
sz
sz
sz
sz
sz
sz
sz
sz
sz
sz
sz
sz
sz
sz
sz
sz
sz
sz
sz
sz
sz
sz
sz
sz
sz
sz
sz
sz
sz
sz
sz
sz
sz
sz
sz
sz
sz
sz
sz
sz
sz
sz
sz
sz
sz
sz
sz
sz
sz
sz
sz
sz
sz
sz
sz
sz
sz
sz
sz
sz
sz
sz
sz
sz
sz
sz
"}
(43,1,1) = {"
sz
sz
sz
sz
sz
sz
sz
sz
sz
sz
sz
sz
sz
sz
sz
sz
sz
sz
sz
sz
sz
sz
sz
sz
sz
sz
sz
sz
sz
sz
sz
sz
sz
sz
sz
sz
sz
sz
sz
sz
sz
sz
sz
sz
sz
sz
sz
sz
sz
sz
sz
sz
sz
sz
sz
sz
sz
sz
sz
sz
sz
sz
sz
sz
sz
sz
sz
sz
sz
sz
sz
sz
sz
"}
(44,1,1) = {"
sz
sz
sz
sz
sz
sz
sz
sz
sz
sz
sz
sz
sz
sz
sz
sz
sz
sz
sz
sz
sz
sz
sz
sz
sz
sz
sz
sz
sz
sz
sz
sz
sz
sz
sz
sz
sz
sz
sz
sz
sz
sz
sz
sz
sz
sz
sz
sz
sz
sz
sz
sz
sz
sz
sz
sz
sz
sz
sz
sz
sz
sz
sz
sz
sz
sz
sz
sz
sz
sz
sz
sz
sz
"}
(45,1,1) = {"
sz
sz
sz
sz
sz
sz
sz
sz
sz
sz
sz
sz
sz
sz
sz
sz
sz
sz
sz
sz
sz
sz
sz
sz
sz
sz
sz
sz
sz
sz
sz
sz
sz
sz
sz
sz
sz
sz
sz
sz
sz
sz
sz
sz
sz
sz
sz
sz
sz
sz
sz
sz
sz
sz
sz
sz
sz
sz
sz
sz
sz
sz
sz
sz
sz
sz
sz
sz
sz
sz
sz
sz
sz
"}
(46,1,1) = {"
sz
sz
sz
sz
sz
sz
sz
sz
sz
sz
sz
sz
sz
sz
sz
sz
sz
sz
sz
sz
sz
sz
sz
sz
sz
sz
sz
sz
sz
sz
sz
sz
sz
sz
sz
sz
sz
sz
sz
sz
sz
sz
sz
sz
sz
sz
sz
sz
sz
sz
sz
sz
sz
sz
sz
sz
sz
sz
sz
sz
sz
sz
sz
sz
sz
sz
sz
sz
sz
sz
sz
sz
sz
"}
(47,1,1) = {"
sz
sz
sz
sz
sz
sz
sz
sz
sz
sz
sz
sz
sz
sz
sz
sz
sz
sz
sz
sz
sz
sz
sz
sz
sz
sz
sz
sz
sz
sz
sz
sz
sz
sz
sz
sz
sz
sz
sz
sz
sz
sz
sz
sz
sz
sz
sz
sz
sz
sz
sz
sz
sz
sz
sz
sz
sz
sz
sz
sz
sz
sz
sz
sz
sz
sz
sz
sz
sz
sz
sz
sz
sz
"}
(48,1,1) = {"
sz
sz
sz
sz
sz
sz
sz
sz
sz
sz
sz
sz
sz
sz
sz
sz
sz
sz
sz
sz
sz
sz
sz
sz
sz
sz
sz
sz
sz
sz
sz
sz
sz
sz
sz
sz
sz
sz
sz
sz
sz
sz
sz
sz
sz
sz
sz
sz
sz
sz
sz
sz
sz
sz
sz
sz
sz
sz
sz
sz
sz
sz
sz
sz
sz
sz
sz
sz
sz
sz
sz
sz
sz
"}
(49,1,1) = {"
sz
sz
sz
sz
sz
sz
sz
sz
sz
sz
sz
sz
sz
sz
sz
sz
sz
sz
sz
sz
sz
sz
sz
sz
sz
sz
sz
sz
sz
sz
sz
sz
sz
sz
sz
sz
sz
sz
sz
sz
sz
sz
sz
sz
sz
sz
sz
sz
sz
sz
sz
sz
sz
sz
sz
sz
sz
sz
sz
sz
sz
sz
sz
sz
sz
sz
sz
sz
sz
sz
sz
sz
sz
"}
(50,1,1) = {"
sz
sz
sz
sz
sz
sz
sz
sz
sz
sz
sz
sz
sz
sz
sz
sz
sz
sz
sz
sz
sz
sz
sz
sz
sz
sz
sz
sz
sz
sz
sz
sz
sz
sz
sz
sz
sz
sz
sz
sz
sz
sz
sz
sz
sz
sz
sz
sz
sz
sz
sz
sz
sz
sz
sz
sz
sz
sz
sz
sz
sz
sz
sz
sz
sz
sz
sz
sz
sz
sz
sz
sz
sz
"}
(51,1,1) = {"
sz
sz
sz
sz
sz
sz
sz
sz
sz
sz
sz
sz
sz
sz
sz
sz
sz
sz
sz
sz
sz
sz
sz
sz
sz
sz
sz
sz
sz
sz
sz
sz
sz
sz
sz
sz
sz
sz
sz
sz
sz
sz
sz
sz
sz
sz
sz
sz
sz
sz
sz
sz
sz
sz
sz
sz
sz
sz
sz
sz
sz
sz
sz
sz
sz
sz
sz
sz
sz
sz
sz
sz
sz
"}
(52,1,1) = {"
sz
sz
sz
sz
sz
sz
sz
sz
sz
sz
sz
sz
sz
sz
sz
sz
sz
sz
sz
sz
sz
sz
sz
sz
sz
sz
sz
sz
sz
sz
sz
sz
sz
sz
sz
sz
sz
sz
sz
sz
sz
sz
sz
sz
sz
sz
sz
sz
sz
sz
sz
sz
sz
sz
sz
sz
sz
sz
sz
sz
sz
sz
sz
sz
sz
sz
sz
sz
sz
sz
sz
sz
sz
"}
(53,1,1) = {"
sz
sz
sz
sz
sz
sz
sz
sz
sz
sz
sz
sz
sz
sz
sz
sz
sz
sz
sz
sz
sz
sz
sz
sz
sz
sz
sz
sz
sz
sz
sz
sz
sz
sz
sz
sz
sz
sz
sz
sz
sz
sz
sz
sz
sz
sz
sz
sz
sz
sz
sz
sz
sz
sz
sz
sz
sz
sz
sz
sz
sz
sz
sz
sz
sz
sz
sz
sz
sz
sz
sz
sz
sz
"}
(54,1,1) = {"
sz
sz
sz
sz
sz
sz
sz
sz
sz
sz
sz
sz
sz
sz
sz
sz
sz
sz
sz
sz
sz
sz
sz
sz
sz
sz
sz
sz
sz
sz
sz
sz
sz
sz
sz
sz
sz
sz
sz
sz
sz
sz
sz
sz
sz
sz
sz
sz
sz
sz
sz
sz
sz
sz
sz
sz
sz
sz
sz
sz
sz
sz
sz
sz
sz
sz
sz
sz
sz
sz
sz
sz
sz
"}
(55,1,1) = {"
sz
sz
sz
sz
sz
sz
sz
sz
sz
sz
sz
sz
sz
sz
sz
sz
sz
sz
sz
sz
sz
sz
sz
sz
sz
sz
sz
sz
sz
sz
sz
sz
sz
sz
sz
sz
sz
sz
sz
sz
sz
sz
sz
sz
sz
sz
sz
sz
sz
sz
sz
sz
sz
sz
sz
sz
sz
sz
sz
sz
sz
sz
sz
sz
sz
sz
sz
sz
sz
sz
sz
sz
sz
"}
(56,1,1) = {"
sz
sz
sz
sz
sz
sz
sz
sz
sz
sz
sz
sz
sz
sz
sz
sz
sz
sz
sz
sz
sz
sz
sz
sz
sz
sz
sz
sz
sz
sz
sz
sz
sz
sz
sz
sz
sz
sz
sz
sz
sz
sz
sz
sz
sz
sz
sz
sz
sz
sz
sz
sz
sz
sz
sz
sz
sz
sz
sz
sz
sz
sz
sz
sz
sz
sz
sz
sz
sz
sz
sz
sz
sz
"}
(57,1,1) = {"
sz
sz
sz
sz
sz
sz
sz
sz
sz
sz
sz
sz
sz
sz
sz
sz
sz
sz
sz
sz
sz
sz
sz
sz
sz
sz
sz
sz
sz
sz
sz
sz
sz
sz
sz
sz
sz
sz
sz
sz
sz
sz
sz
sz
sz
sz
sz
sz
sz
sz
sz
sz
sz
sz
sz
sz
sz
sz
sz
sz
sz
sz
sz
sz
sz
sz
sz
sz
sz
sz
sz
sz
sz
"}
(58,1,1) = {"
sz
sz
sz
sz
sz
sz
sz
sz
sz
sz
sz
sz
sz
sz
sz
sz
sz
sz
sz
sz
sz
sz
sz
sz
sz
sz
sz
sz
sz
sz
sz
sz
sz
sz
sz
sz
sz
sz
sz
sz
sz
sz
sz
sz
sz
sz
sz
sz
sz
sz
sz
sz
sz
sz
sz
sz
sz
sz
sz
sz
sz
sz
sz
sz
sz
sz
sz
sz
sz
sz
sz
sz
sz
"}
(59,1,1) = {"
sz
sz
sz
sz
sz
sz
sz
sz
sz
sz
sz
sz
sz
sz
sz
sz
sz
sz
sz
sz
sz
sz
sz
sz
sz
sz
sz
sz
sz
sz
sz
sz
sz
sz
sz
sz
sz
sz
sz
sz
sz
sz
sz
sz
sz
sz
sz
sz
sz
sz
sz
sz
sz
sz
sz
sz
sz
sz
sz
sz
sz
sz
sz
sz
sz
sz
sz
sz
sz
sz
sz
sz
sz
"}
(60,1,1) = {"
sz
sz
sz
sz
sz
sz
sz
sz
sz
sz
sz
sz
sz
sz
sz
sz
sz
sz
sz
sz
sz
sz
sz
sz
sz
sz
sz
sz
sz
sz
sz
sz
sz
sz
sz
sz
sz
sz
sz
sz
sz
sz
sz
sz
sz
sz
sz
sz
sz
sz
sz
sz
sz
sz
sz
sz
sz
sz
sz
sz
sz
sz
sz
sz
sz
sz
sz
sz
sz
sz
sz
sz
sz
"}
(61,1,1) = {"
sz
sz
sz
sz
sz
sz
sz
sz
sz
sz
sz
sz
sz
sz
sz
sz
sz
sz
sz
sz
sz
sz
sz
sz
sz
sz
sz
sz
sz
sz
sz
sz
sz
sz
sz
sz
sz
sz
sz
sz
sz
sz
sz
sz
sz
sz
sz
sz
sz
sz
sz
sz
sz
sz
sz
sz
sz
sz
sz
sz
sz
sz
sz
sz
sz
sz
sz
sz
sz
sz
sz
sz
sz
"}
(62,1,1) = {"
sz
sz
sz
sz
sz
sz
sz
sz
sz
sz
sz
sz
sz
sz
sz
sz
sz
sz
sz
sz
sz
sz
sz
sz
sz
sz
sz
sz
sz
sz
sz
sz
sz
sz
sz
sz
sz
sz
sz
sz
sz
sz
sz
sz
sz
sz
sz
sz
sz
sz
sz
sz
sz
sz
sz
sz
sz
sz
sz
sz
sz
sz
sz
sz
sz
sz
sz
sz
sz
sz
sz
sz
sz
"}
(63,1,1) = {"
sz
sz
sz
sz
sz
sz
sz
sz
sz
sz
sz
sz
sz
sz
sz
sz
sz
sz
sz
sz
sz
sz
sz
sz
sz
sz
sz
sz
sz
sz
sz
sz
sz
sz
sz
sz
sz
sz
sz
sz
sz
sz
sz
sz
sz
sz
sz
sz
sz
sz
sz
sz
sz
sz
sz
sz
sz
sz
sz
sz
sz
sz
sz
sz
sz
sz
sz
sz
sz
sz
sz
sz
sz
"}
(64,1,1) = {"
sz
sz
sz
sz
sz
sz
sz
sz
sz
sz
sz
sz
sz
sz
sz
sz
sz
sz
sz
sz
sz
sz
sz
sz
sz
sz
sz
sz
sz
sz
sz
sz
sz
sz
sz
sz
sz
sz
sz
sz
sz
sz
sz
sz
sz
sz
sz
sz
sz
sz
sz
sz
sz
sz
sz
sz
sz
sz
sz
sz
sz
sz
sz
sz
sz
sz
sz
sz
sz
sz
sz
sz
sz
"}
(65,1,1) = {"
sz
sz
sz
sz
sz
sz
sz
sz
sz
sz
sz
sz
sz
sz
sz
sz
sz
sz
sz
sz
sz
sz
sz
sz
sz
sz
sz
sz
sz
sz
sz
sz
sz
sz
sz
sz
sz
sz
sz
sz
sz
sz
sz
sz
sz
sz
sz
sz
sz
sz
sz
sz
sz
sz
sz
sz
sz
sz
sz
sz
sz
sz
sz
sz
sz
sz
sz
sz
sz
sz
sz
sz
sz
"}
(66,1,1) = {"
sz
sz
sz
sz
sz
sz
sz
sz
sz
sz
sz
sz
sz
sz
sz
sz
sz
sz
sz
sz
sz
sz
sz
sz
sz
sz
sz
sz
sz
sz
sz
sz
sz
sz
sz
sz
sz
sz
sz
sz
sz
sz
sz
sz
sz
sz
sz
sz
sz
sz
sz
sz
sz
sz
sz
sz
sz
sz
sz
sz
sz
sz
sz
sz
sz
sz
sz
sz
sz
sz
sz
sz
sz
"}
(67,1,1) = {"
sz
sz
sz
sz
sz
sz
sz
sz
sz
sz
sz
sz
sz
sz
sz
sz
sz
sz
sz
sz
sz
sz
sz
sz
sz
sz
sz
sz
sz
sz
sz
sz
sz
sz
sz
sz
sz
sz
sz
sz
sz
sz
sz
sz
sz
sz
sz
sz
sz
sz
sz
sz
sz
sz
sz
sz
sz
sz
sz
sz
sz
sz
sz
sz
sz
sz
sz
sz
sz
sz
sz
sz
sz
"}
(68,1,1) = {"
sz
sz
sz
sz
sz
sz
sz
sz
sz
sz
sz
sz
sz
sz
sz
sz
sz
sz
sz
sz
sz
sz
sz
sz
sz
sz
sz
sz
sz
sz
sz
sz
sz
sz
sz
sz
sz
sz
sz
sz
sz
sz
sz
sz
sz
sz
sz
sz
sz
sz
sz
sz
sz
sz
sz
sz
sz
sz
sz
sz
sz
sz
sz
sz
sz
sz
sz
sz
sz
sz
sz
sz
sz
"}
(69,1,1) = {"
sz
sz
sz
sz
sz
sz
sz
sz
sz
sz
sz
sz
sz
sz
sz
sz
sz
sz
sz
sz
sz
sz
sz
sz
sz
sz
sz
sz
sz
sz
sz
sz
sz
sz
sz
sz
sz
sz
sz
sz
sz
sz
sz
sz
sz
sz
sz
sz
sz
sz
sz
sz
sz
sz
sz
sz
sz
sz
sz
sz
sz
sz
sz
sz
sz
sz
sz
sz
sz
sz
sz
sz
sz
"}
(70,1,1) = {"
sz
sz
sz
sz
sz
sz
sz
sz
sz
sz
sz
sz
sz
sz
sz
sz
sz
sz
sz
sz
sz
sz
sz
sz
sz
sz
sz
sz
sz
sz
sz
sz
sz
sz
sz
sz
sz
sz
sz
sz
sz
sz
sz
sz
sz
sz
sz
sz
sz
sz
sz
sz
sz
sz
sz
sz
sz
sz
sz
sz
sz
sz
sz
sz
sz
sz
sz
sz
sz
sz
sz
sz
sz
"}
