//MAP CONVERTED BY dmm2tgm.py THIS HEADER COMMENT PREVENTS RECONVERSION, DO NOT REMOVE
"ap" = (
/obj/structure/flora/tree/jungle,
/turf/open/floor/plating/smooth/grass/lavaland_jungle,
/area/hilbertshotel)
"au" = (
/obj/item/cushion{
	pixel_x = 11;
	pixel_y = 1
	},
/turf/open/floor/plating/smooth/grass/lavaland_jungle,
/area/hilbertshotel)
"aK" = (
/obj/structure/chair/sofa/corp/left{
	dir = 4
	},
/turf/open/floor/pod/dark,
/area/hilbertshotel)
"bl" = (
/obj/structure/chair/sofa/corp/right{
	dir = 4
	},
/turf/open/floor/pod/dark,
/area/hilbertshotel)
"bD" = (
/turf/open/floor/wood/wood_tiled,
/area/hilbertshotel)
"bL" = (
/obj/structure/fans,
/turf/open/floor/pod/dark,
/area/hilbertshotel)
"bP" = (
/obj/effect/turf_decal/siding/wood,
/turf/open/floor/wood/wood_tiled,
/area/hilbertshotel)
"cA" = (
/turf/closed/wall/mineral/titanium/survival/pod,
/area/hilbertshotel)
"eg" = (
/obj/structure/fluff/railing{
	dir = 8;
	pixel_y = 0;
	pixel_x = 29
	},
/turf/closed/wall/mineral/titanium/survival/pod,
/area/hilbertshotel)
"eH" = (
/obj/structure/sign/mining/survival{
	dir = 1
	},
/turf/closed/wall/mineral/titanium/survival/pod,
/area/hilbertshotel)
"fj" = (
/obj/item/bikehorn/rubberducky{
	pixel_y = -7
	},
/turf/open/water/jungle,
/area/hilbertshotel)
"fP" = (
/turf/open/floor/plating/smooth/grass/lavaland_jungle,
/area/hilbertshotel)
"fX" = (
/obj/structure/flora/rock/jungle,
/turf/open/floor/plating/smooth/grass/lavaland_jungle,
/area/hilbertshotel)
"hj" = (
/turf/open/floor/plating/asteroid/basalt{
	initial_gas_mix = "LAVALAND_ATMOS"
	},
/area/hilbertshotel)
"jg" = (
/turf/open/water/jungle,
/area/hilbertshotel)
"jv" = (
/obj/structure/flora/grass/jungle,
/turf/open/floor/plating/smooth/grass/lavaland_jungle,
/area/hilbertshotel)
"jy" = (
/obj/structure/ore_box{
	layer = 2.1
	},
/obj/effect/turf_decal/box{
	layer = 2
	},
/turf/open/floor/pod/dark,
/area/hilbertshotel)
"jE" = (
/obj/item/toy/beach_ball,
/turf/open/water/jungle,
/area/hilbertshotel)
"kd" = (
/obj/effect/turf_decal{
	dir = 4
	},
/obj/effect/turf_decal/vg_decals/numbers/six,
/turf/open/floor/pod/dark{
	pixel_x = 0;
	pixel_y = 0
	},
/area/hilbertshotel)
"ln" = (
/obj/structure/flora/rock/pile,
/turf/open/floor/plating/asteroid/basalt{
	initial_gas_mix = "LAVALAND_ATMOS"
	},
/area/hilbertshotel)
"lw" = (
/obj/structure/fans/tiny,
/obj/structure/window/shuttle/survival_pod,
/turf/open/floor/pod/dark,
/area/hilbertshotel)
"mo" = (
/obj/structure/flora/ausbushes/lavendergrass,
/turf/open/floor/plating/smooth/grass/lavaland_jungle,
/area/hilbertshotel)
"mC" = (
/obj/effect/turf_decal/siding/wood{
	dir = 5
	},
/obj/machinery/vending/kink{
	onstation = 0;
	shut_up = 1
	},
/turf/open/floor/wood/wood_tiled,
/area/hilbertshotel)
"nl" = (
/obj/effect/turf_decal/siding/wood{
	dir = 10
	},
/turf/open/floor/wood/wood_tiled,
/area/hilbertshotel)
"ns" = (
/obj/structure/dresser,
/turf/open/floor/carpet/royalblack,
/area/hilbertshotel)
"oh" = (
/obj/structure/rack,
/obj/item/shovel{
	pixel_x = 2;
	pixel_y = -4
	},
/obj/item/pickaxe{
	pixel_x = 1;
	pixel_y = 2
	},
/obj/item/pickaxe{
	pixel_x = -4;
	pixel_y = 2
	},
/obj/effect/turf_decal/bot_white,
/obj/effect/turf_decal{
	dir = 1
	},
/obj/effect/turf_decal{
	dir = 4
	},
/turf/open/floor/pod/dark,
/area/hilbertshotel)
"os" = (
/obj/item/storage/box/donkpockets{
	pixel_y = 7;
	pixel_x = 0
	},
/obj/structure/table/wood/fancy/monochrome,
/obj/machinery/light/directional,
/turf/open/floor/pod/dark,
/area/hilbertshotel)
"oO" = (
/obj/structure/table/wood/fancy/monochrome,
/obj/item/reagent_containers/food/drinks/beer{
	pixel_x = -5;
	pixel_y = 11
	},
/obj/item/reagent_containers/food/drinks/beer{
	pixel_x = 6;
	pixel_y = 10
	},
/obj/item/reagent_containers/food/drinks/beer{
	pixel_x = 0;
	pixel_y = 7
	},
/obj/machinery/light/directional,
/turf/open/floor/pod/dark,
/area/hilbertshotel)
"oP" = (
/obj/structure/flora/spookyrock,
/turf/open/floor/plating/asteroid/basalt{
	initial_gas_mix = "LAVALAND_ATMOS"
	},
/area/hilbertshotel)
"rK" = (
/obj/structure/flora/junglebush,
/turf/open/water/jungle,
/area/hilbertshotel)
"rS" = (
/obj/structure/fluff/railing{
	dir = 4;
	pixel_y = 0;
	pixel_x = -29
	},
/turf/closed/wall/mineral/titanium/survival/pod,
/area/hilbertshotel)
"sf" = (
/obj/structure/flora/rock/pile/icy,
/turf/open/floor/plating/asteroid/basalt{
	initial_gas_mix = "LAVALAND_ATMOS"
	},
/area/hilbertshotel)
"sw" = (
/obj/effect/turf_decal/siding/wood{
	dir = 6
	},
/obj/item/kirbyplants,
/turf/open/floor/wood/wood_tiled,
/area/hilbertshotel)
"sX" = (
/obj/structure/flora/junglebush/large,
/turf/open/water/jungle,
/area/hilbertshotel)
"tq" = (
/obj/machinery/telecomms/relay/preset/auto,
/turf/open/floor/pod/dark,
/area/hilbertshotel)
"tU" = (
/obj/machinery/door/airlock/survival_pod,
/turf/open/floor/pod/dark,
/area/hilbertshotel)
"uD" = (
/obj/structure/fans/tiny,
/obj/machinery/door/airlock/survival_pod/glass,
/turf/open/floor/pod/dark,
/area/hilbertshotel)
"va" = (
/obj/effect/turf_decal/siding/wood{
	dir = 4
	},
/turf/open/floor/wood/wood_tiled,
/area/hilbertshotel)
"wC" = (
/obj/item/reagent_containers/glass/beaker/waterbottle{
	pixel_x = 0;
	pixel_y = 4
	},
/obj/item/reagent_containers/glass/beaker/waterbottle{
	pixel_x = -6;
	pixel_y = 6
	},
/obj/structure/table/wood/fancy/monochrome,
/obj/item/reagent_containers/glass/beaker/waterbottle{
	pixel_x = 4;
	pixel_y = 8
	},
/turf/open/floor/pod/dark,
/area/hilbertshotel)
"wD" = (
/obj/effect/turf_decal{
	dir = 4
	},
/turf/open/floor/pod/dark,
/area/hilbertshotel)
"wO" = (
/obj/item/cushion{
	pixel_x = -1;
	pixel_y = -7
	},
/turf/open/floor/plating/smooth/grass/lavaland_jungle,
/area/hilbertshotel)
"xo" = (
/obj/machinery/shower{
	dir = 1
	},
/obj/structure/curtain,
/obj/item/soap/nanotrasen,
/turf/open/floor/pod/dark,
/area/hilbertshotel)
"yq" = (
/obj/structure/window/shuttle/survival_pod,
/obj/structure/fans/tiny,
/turf/open/floor/pod/dark,
/area/hilbertshotel)
"yP" = (
/obj/structure/flora/grass/jungle/b,
/obj/structure/flora/tree/jungle/small,
/turf/open/floor/plating/smooth/grass/lavaland_jungle,
/area/hilbertshotel)
"zH" = (
/obj/structure/flora/ausbushes/ppflowers,
/turf/open/floor/plating/smooth/grass/lavaland_jungle,
/area/hilbertshotel)
"zW" = (
/obj/item/lighter/gold,
/turf/open/floor/plating/smooth/grass/lavaland_jungle,
/area/hilbertshotel)
"Ad" = (
/obj/structure/closet/cabinet,
/obj/structure/sign/poster/contraband/random{
	pixel_x = -31
	},
/turf/open/floor/carpet/royalblack,
/area/hilbertshotel)
"Al" = (
/obj/structure/flora/ausbushes/ywflowers,
/turf/open/floor/plating/smooth/grass/lavaland_jungle,
/area/hilbertshotel)
"Bo" = (
/obj/effect/turf_decal/vg_decals/department/mining,
/turf/open/floor/pod/dark,
/area/hilbertshotel)
"BP" = (
/obj/effect/turf_decal/siding/wood{
	dir = 8
	},
/obj/effect/turf_decal/siding/wood{
	dir = 9
	},
/obj/structure/fluff/railing/corner{
	dir = 1;
	pixel_x = -2
	},
/obj/structure/fluff/railing/corner{
	dir = 4;
	pixel_x = 2;
	pixel_y = 0
	},
/turf/open/floor/wood/wood_tiled,
/area/hilbertshotel)
"Cd" = (
/obj/effect/turf_decal/siding/wood{
	dir = 8
	},
/turf/open/floor/wood/wood_tiled,
/area/hilbertshotel)
"Cl" = (
/obj/structure/flora/tree/mushroom,
/turf/open/floor/plating/asteroid/basalt{
	initial_gas_mix = "LAVALAND_ATMOS"
	},
/area/hilbertshotel)
"Cy" = (
/obj/effect/turf_decal/bot_white,
/obj/machinery/light/directional{
	dir = 1
	},
/obj/structure/rack{
	pixel_x = 0;
	pixel_y = 0
	},
/turf/open/floor/pod/dark,
/area/hilbertshotel)
"CC" = (
/obj/machinery/light_switch/directional/west,
/turf/open/floor/pod/dark,
/area/hilbertshotel)
"CQ" = (
/obj/item/toy/plush/bubbleplush,
/turf/open/floor/plating/asteroid/basalt{
	initial_gas_mix = "LAVALAND_ATMOS"
	},
/area/hilbertshotel)
"Eg" = (
/turf/closed/wall/mineral/titanium/survival/nodiagonal,
/area/hilbertshotel)
"EA" = (
/obj/machinery/light_switch/directional/north,
/turf/open/floor/carpet/royalblack,
/area/hilbertshotel)
"EL" = (
/obj/item/storage/box/marshmallow,
/turf/open/floor/plating/smooth/grass/lavaland_jungle,
/area/hilbertshotel)
"EU" = (
/obj/structure/fluff/railing/corner{
	dir = 8;
	pixel_x = -2
	},
/obj/structure/fluff/railing/corner{
	pixel_x = 2;
	pixel_y = 0
	},
/turf/open/floor/pod/dark,
/area/hilbertshotel)
"Gf" = (
/obj/structure/sign/poster/contraband/random{
	pixel_x = 0;
	pixel_y = 0
	},
/turf/closed/wall/mineral/titanium/survival/pod,
/area/hilbertshotel)
"GI" = (
/obj/structure/mecha_wreckage/ripley,
/turf/open/floor/plating/asteroid/basalt{
	initial_gas_mix = "LAVALAND_ATMOS"
	},
/area/hilbertshotel)
"GU" = (
/obj/structure/flora/tree/shadow,
/turf/open/floor/plating/asteroid/basalt{
	initial_gas_mix = "LAVALAND_ATMOS"
	},
/area/hilbertshotel)
"HD" = (
/obj/item/toy/plush/miner,
/turf/open/floor/plating/asteroid/basalt{
	initial_gas_mix = "LAVALAND_ATMOS"
	},
/area/hilbertshotel)
"IM" = (
/obj/machinery/smartfridge/survival_pod,
/turf/open/floor/pod/dark,
/area/hilbertshotel)
"Jy" = (
/turf/closed/indestructible/rock,
/area/hilbertshotel)
"JL" = (
/turf/closed/indestructible/hoteldoor{
	icon_state = "door_closed";
	icon = 'icons/obj/doors/puzzledoor/default.dmi'
	},
/area/hilbertshotel)
"Ke" = (
/obj/effect/turf_decal/arrows{
	dir = 1
	},
/turf/open/floor/pod/dark,
/area/hilbertshotel)
"KW" = (
/obj/structure/rack{
	pixel_x = 0;
	pixel_y = 0
	},
/obj/item/tank/internals/oxygen{
	pixel_x = -6;
	pixel_y = 6
	},
/obj/item/tank/internals/oxygen{
	pixel_x = -3;
	pixel_y = 4
	},
/obj/item/clothing/mask/breath{
	pixel_x = 4;
	pixel_y = 0
	},
/obj/item/clothing/mask/breath{
	pixel_x = -1;
	pixel_y = -3
	},
/obj/effect/turf_decal/bot_white,
/obj/effect/turf_decal{
	dir = 1
	},
/turf/open/floor/pod/dark,
/area/hilbertshotel)
"KZ" = (
/obj/machinery/microwave,
/obj/structure/table/wood/fancy/monochrome,
/turf/open/floor/pod/dark,
/area/hilbertshotel)
"Ln" = (
/turf/open/floor/pod/dark,
/area/hilbertshotel)
"Lz" = (
/obj/structure/bed/double/pod{
	dir = 1
	},
/obj/item/bedsheet/brown/double{
	dir = 1
	},
/turf/open/floor/carpet/royalblack,
/area/hilbertshotel)
"LS" = (
/turf/open/floor/iron/stairs,
/area/hilbertshotel)
"MA" = (
/obj/structure/flora/grass/jungle/b,
/turf/open/floor/plating/smooth/grass/lavaland_jungle,
/area/hilbertshotel)
"NF" = (
/obj/machinery/light/small,
/turf/open/water/jungle,
/area/hilbertshotel)
"Ox" = (
/obj/structure/toilet{
	pixel_x = -4;
	pixel_y = 8
	},
/obj/structure/sink/kitchen/directional/west{
	pixel_y = 11
	},
/obj/machinery/light/directional{
	dir = 8
	},
/turf/open/floor/pod/dark,
/area/hilbertshotel)
"OD" = (
/obj/structure/flora/biolumi/mine,
/turf/open/water/jungle,
/area/hilbertshotel)
"Pl" = (
/obj/effect/turf_decal/siding/wood{
	dir = 1
	},
/obj/structure/closet/crate/bin{
	pixel_x = 12;
	pixel_y = 9
	},
/obj/machinery/light/directional{
	dir = 1
	},
/turf/open/floor/wood/wood_tiled,
/area/hilbertshotel)
"PF" = (
/obj/machinery/light/directional,
/obj/structure/table/wood,
/obj/item/blackcomb,
/turf/open/floor/carpet/royalblack,
/area/hilbertshotel)
"Qi" = (
/obj/machinery/light/small/blacklight/directional/west,
/obj/machinery/portable_atmospherics/canister/air{
	layer = 1
	},
/turf/open/floor/plating/asteroid/basalt{
	initial_gas_mix = "LAVALAND_ATMOS"
	},
/area/hilbertshotel)
"QJ" = (
/obj/item/gps/computer,
/turf/open/floor/pod/dark,
/area/hilbertshotel)
"Rc" = (
/turf/closed/mineral/volcanic,
/area/hilbertshotel)
"Rl" = (
/obj/structure/mirror/directional/east,
/turf/open/floor/pod/dark,
/area/hilbertshotel)
"TM" = (
/obj/structure/table/wood/fancy/monochrome,
/obj/item/reagent_containers/food/snacks/bbqribs,
/obj/item/reagent_containers/food/snacks/bbqribs{
	pixel_x = 2;
	pixel_y = 3
	},
/turf/open/floor/pod/dark,
/area/hilbertshotel)
"Vd" = (
/turf/open/floor/carpet/royalblack,
/area/hilbertshotel)
"WG" = (
/obj/structure/ore_box{
	layer = 2.1
	},
/obj/effect/turf_decal/box{
	layer = 2
	},
/obj/effect/turf_decal{
	dir = 4
	},
/obj/machinery/light/small/blacklight/directional/west{
	dir = 2
	},
/turf/open/floor/pod/dark,
/area/hilbertshotel)
"Yb" = (
/obj/structure/bonfire/dense,
/turf/open/floor/plating/smooth/grass/lavaland_jungle,
/area/hilbertshotel)
"YN" = (
/obj/structure/rack/shelf,
/obj/item/clothing/shoes/sandal{
	pixel_x = 0;
	pixel_y = -7
	},
/obj/item/clothing/shoes/sandal{
	pixel_x = 0;
	pixel_y = 2
	},
/obj/item/flashlight{
	pixel_x = 0;
	pixel_y = 18
	},
/obj/effect/turf_decal/bot_white,
/turf/open/floor/pod/dark,
/area/hilbertshotel)
"Zr" = (
/obj/effect/turf_decal/box/white,
/turf/open/floor/pod/dark,
/area/hilbertshotel)

(1,1,1) = {"
Jy
Jy
Jy
Jy
Jy
Eg
cA
JL
cA
cA
cA
cA
cA
cA
cA
cA
"}
(2,1,1) = {"
Jy
OD
jg
jg
jg
cA
Cy
Ln
CC
KZ
os
cA
Ad
Lz
ns
cA
"}
(3,1,1) = {"
Jy
jg
fj
sX
jg
cA
YN
Ln
Ln
Ln
wC
eg
EA
Vd
PF
cA
"}
(4,1,1) = {"
Jy
rK
OD
jE
jg
eH
bL
Ln
Zr
Ln
EU
LS
BP
Cd
nl
cA
"}
(5,1,1) = {"
Jy
jg
jg
jg
jg
Gf
IM
Ln
Ln
bl
aK
rS
Pl
bD
bP
cA
"}
(6,1,1) = {"
Jy
fP
fP
jg
rK
cA
QJ
Ln
Ln
TM
oO
cA
mC
va
sw
cA
"}
(7,1,1) = {"
Jy
Al
mo
fP
NF
Eg
yq
uD
lw
yq
yq
cA
cA
tU
cA
cA
"}
(8,1,1) = {"
Jy
fP
yP
jv
fP
Qi
KW
Ke
Bo
Ln
jy
cA
Ox
Rl
xo
cA
"}
(9,1,1) = {"
Jy
fX
jv
fP
hj
hj
oh
wD
kd
wD
WG
Eg
cA
cA
cA
cA
"}
(10,1,1) = {"
Jy
fP
zH
zH
hj
hj
hj
GU
hj
hj
hj
Rc
Rc
cA
tq
cA
"}
(11,1,1) = {"
Jy
MA
fP
ap
zW
oP
hj
hj
hj
hj
ln
Rc
Rc
Eg
cA
Eg
"}
(12,1,1) = {"
Jy
zH
fP
au
Yb
hj
hj
hj
hj
hj
Rc
Rc
Rc
Rc
Rc
Jy
"}
(13,1,1) = {"
Jy
jv
MA
wO
EL
fP
hj
hj
hj
Rc
Rc
Rc
Rc
Rc
CQ
Jy
"}
(14,1,1) = {"
Jy
mo
fP
fP
hj
hj
hj
hj
Rc
Rc
Rc
Rc
hj
hj
hj
Jy
"}
(15,1,1) = {"
Jy
ln
fP
hj
Cl
hj
hj
sf
Rc
Rc
Rc
Rc
Rc
GI
HD
Jy
"}
(16,1,1) = {"
Jy
Jy
Jy
Jy
Jy
Jy
Jy
Jy
Jy
Jy
Jy
Jy
Jy
Jy
Jy
Jy
"}
