//MAP CONVERTED BY dmm2tgm.py THIS HEADER COMMENT PREVENTS RECONVERSION, DO NOT REMOVE
"aN" = (
/turf/closed/indestructible/wall,
/area/hilbertshotel)
"aP" = (
/obj/effect/turf_decal/siding/dark,
/turf/open/floor/carpet/black,
/area/hilbertshotel)
"aR" = (
/obj/effect/turf_decal/siding{
	dir = 8
	},
/obj/machinery/light{
	dir = 8
	},
/turf/open/floor/iron/white/small,
/area/hilbertshotel)
"bd" = (
/obj/structure/pool/Rboard,
/obj/effect/turf_decal/siding{
	dir = 4
	},
/turf/open/floor/iron/white/small,
/area/hilbertshotel)
"bW" = (
/obj/machinery/light{
	dir = 4
	},
/turf/open/floor/carpet/royalblack,
/area/hilbertshotel)
"cT" = (
/obj/machinery/door/morgue,
/turf/open/floor/plasteel/dark,
/area/hilbertshotel)
"dI" = (
/obj/structure/chair/sofa/right/brown,
/obj/effect/turf_decal/tile/bar{
	dir = 1
	},
/obj/effect/turf_decal/tile/bar{
	dir = 4
	},
/turf/open/floor/plasteel/shuttle,
/area/hilbertshotel)
"ed" = (
/obj/structure/sign/logo{
	icon_state = "nanotrasen_sign3"
	},
/turf/closed/indestructible/wall,
/area/hilbertshotel)
"eW" = (
/obj/structure/pool/Rboard,
/obj/structure/window/reinforced{
	dir = 4
	},
/obj/effect/turf_decal/siding{
	dir = 4
	},
/turf/open/floor/iron/white/small,
/area/hilbertshotel)
"fb" = (
/obj/structure/chair/pew/right{
	dir = 4
	},
/turf/open/floor/wood/wood_tiled,
/area/hilbertshotel)
"fo" = (
/obj/effect/turf_decal/siding/dark{
	dir = 8
	},
/turf/open/floor/carpet/black,
/area/hilbertshotel)
"fH" = (
/obj/effect/turf_decal/siding/dark{
	dir = 9
	},
/obj/machinery/vending/snack/orange{
	shut_up = 1;
	custom_premium_price = 0;
	custom_price = 0;
	default_price = 0;
	extra_price = 0;
	fair_market_price = 0
	},
/turf/open/floor/carpet/black,
/area/hilbertshotel)
"fI" = (
/obj/structure/window/reinforced{
	dir = 4
	},
/obj/effect/turf_decal/siding{
	dir = 4
	},
/obj/effect/turf_decal/siding{
	dir = 4
	},
/obj/effect/turf_decal/siding/white/corner{
	dir = 1
	},
/turf/open/floor/iron/white/small,
/area/hilbertshotel)
"gP" = (
/obj/structure/weightmachine/stacklifter,
/turf/open/floor/carpet/black,
/area/hilbertshotel)
"gV" = (
/obj/machinery/status_display/evac{
	layer = 4;
	pixel_y = 32
	},
/turf/closed/indestructible/wall,
/area/hilbertshotel)
"hw" = (
/obj/structure/sauna_oven,
/obj/structure/stone_tile,
/obj/structure/stone_tile{
	dir = 8
	},
/obj/structure/stone_tile{
	dir = 1
	},
/obj/structure/stone_tile{
	dir = 4
	},
/obj/item/stack/sheet/mineral/wood/fifty,
/turf/open/floor/wood/wood_tiled,
/area/hilbertshotel)
"ix" = (
/obj/effect/turf_decal/siding{
	dir = 8
	},
/turf/open/floor/iron/white/small,
/area/hilbertshotel)
"jb" = (
/obj/effect/turf_decal/siding/dark{
	dir = 6
	},
/turf/open/floor/carpet/black,
/area/hilbertshotel)
"jn" = (
/obj/effect/turf_decal/tile/neutral,
/obj/effect/turf_decal/tile/neutral{
	dir = 1
	},
/obj/effect/turf_decal/tile/neutral{
	dir = 4
	},
/obj/effect/turf_decal/tile/neutral{
	dir = 8
	},
/obj/structure/window/reinforced{
	dir = 1;
	layer = 2.9
	},
/obj/effect/turf_decal/tile/dark_blue{
	dir = 4
	},
/obj/effect/turf_decal/tile/dark_blue{
	dir = 4
	},
/obj/effect/turf_decal/tile/dark_blue{
	dir = 4
	},
/obj/effect/turf_decal/tile/dark_blue{
	dir = 1
	},
/obj/effect/turf_decal/tile/dark_blue{
	dir = 1
	},
/obj/effect/turf_decal/tile/dark_blue{
	dir = 1
	},
/turf/open/floor/plasteel/dark,
/area/hilbertshotel)
"jP" = (
/obj/structure/sign/logo,
/turf/closed/indestructible/wall,
/area/hilbertshotel)
"kq" = (
/obj/effect/turf_decal/siding{
	dir = 6
	},
/obj/structure/window/reinforced{
	dir = 4
	},
/turf/open/floor/iron/white/small,
/area/hilbertshotel)
"kY" = (
/obj/structure/chair/stool{
	dir = 4;
	pixel_x = 9
	},
/obj/effect/turf_decal/siding/dark{
	dir = 4
	},
/turf/open/floor/carpet/black,
/area/hilbertshotel)
"lc" = (
/obj/effect/turf_decal/siding{
	dir = 1
	},
/turf/open/floor/iron/white/small,
/area/hilbertshotel)
"ly" = (
/obj/structure/table/bronze,
/obj/item/reagent_containers/glass/bucket{
	pixel_y = 7
	},
/turf/open/floor/wood/wood_tiled,
/area/hilbertshotel)
"mc" = (
/obj/structure/table/glass,
/obj/effect/turf_decal/siding/wood{
	dir = 9
	},
/obj/item/paper_bin,
/turf/open/floor/carpet/royalblack,
/area/hilbertshotel)
"mU" = (
/obj/effect/turf_decal/tile/neutral{
	dir = 8
	},
/obj/effect/turf_decal/tile/neutral,
/obj/effect/turf_decal/tile/neutral{
	dir = 1
	},
/obj/effect/turf_decal/tile/neutral{
	dir = 4
	},
/obj/structure/window/reinforced{
	dir = 8
	},
/obj/effect/turf_decal/tile/dark_red{
	dir = 1
	},
/obj/effect/turf_decal/tile/dark_red{
	dir = 1
	},
/obj/effect/turf_decal/tile/dark_red{
	dir = 1
	},
/obj/effect/turf_decal/tile/dark_red{
	dir = 8
	},
/obj/effect/turf_decal/tile/dark_red{
	dir = 8
	},
/obj/effect/turf_decal/tile/dark_red{
	dir = 8
	},
/turf/open/floor/plasteel/dark,
/area/hilbertshotel)
"nk" = (
/obj/effect/turf_decal/tile/bar,
/turf/open/floor/plasteel/shuttle,
/area/hilbertshotel)
"nJ" = (
/obj/effect/turf_decal/tile/neutral,
/obj/effect/turf_decal/tile/neutral{
	dir = 1
	},
/obj/effect/turf_decal/tile/neutral{
	dir = 4
	},
/obj/effect/turf_decal/tile/neutral{
	dir = 8
	},
/obj/effect/turf_decal/tile/dark_red,
/obj/effect/turf_decal/tile/dark_red,
/obj/effect/turf_decal/tile/dark_red,
/obj/effect/turf_decal/tile/dark_red{
	dir = 8
	},
/obj/effect/turf_decal/tile/dark_red{
	dir = 8
	},
/obj/effect/turf_decal/tile/dark_red{
	dir = 8
	},
/obj/machinery/light,
/turf/open/floor/plasteel/dark,
/area/hilbertshotel)
"od" = (
/obj/machinery/light/small{
	dir = 1
	},
/turf/open/floor/plasteel/dark,
/area/hilbertshotel)
"oz" = (
/obj/structure/pool/ladder{
	dir = 1;
	pixel_y = -24
	},
/turf/open/pool,
/area/hilbertshotel)
"oR" = (
/obj/structure/chair/sofa/left/brown,
/obj/effect/turf_decal/tile/bar{
	dir = 1
	},
/obj/effect/turf_decal/tile/bar{
	dir = 4
	},
/turf/open/floor/plasteel/shuttle,
/area/hilbertshotel)
"oZ" = (
/obj/structure/closet/athletic_mixed,
/obj/machinery/light{
	dir = 8
	},
/turf/open/floor/plasteel/dark,
/area/hilbertshotel)
"pE" = (
/obj/item/toy/beach_ball/holoball{
	pixel_y = -5
	},
/obj/item/toy/beach_ball{
	pixel_y = 22
	},
/obj/structure/rack/shelf,
/turf/open/floor/plasteel/dark,
/area/hilbertshotel)
"pI" = (
/obj/effect/turf_decal/tile/bar,
/obj/effect/turf_decal/tile/bar{
	dir = 4
	},
/obj/effect/turf_decal/tile/bar{
	dir = 8
	},
/turf/open/floor/plasteel/shuttle,
/area/hilbertshotel)
"pJ" = (
/obj/structure/chair/office/dark{
	dir = 8
	},
/turf/open/floor/carpet/royalblack,
/area/hilbertshotel)
"qi" = (
/obj/structure/fluff/railing{
	pixel_y = 32
	},
/turf/open/pool,
/area/hilbertshotel)
"qj" = (
/obj/effect/turf_decal/siding/dark/corner,
/turf/closed/indestructible/wall,
/area/hilbertshotel)
"qv" = (
/obj/structure/chair/pew/right{
	dir = 8
	},
/turf/open/floor/wood/wood_tiled,
/area/hilbertshotel)
"rg" = (
/obj/effect/turf_decal/siding{
	dir = 2
	},
/obj/item/toy/beach_ball,
/turf/open/floor/iron/white/small,
/area/hilbertshotel)
"sK" = (
/obj/structure/chair/sofa/left{
	dir = 8
	},
/turf/open/floor/plasteel/dark,
/area/hilbertshotel)
"tB" = (
/turf/open/floor/plasteel/shuttle,
/area/hilbertshotel)
"tX" = (
/obj/structure/table/glass,
/obj/effect/turf_decal/siding/wood{
	dir = 8
	},
/turf/open/floor/carpet/royalblack,
/area/hilbertshotel)
"uh" = (
/obj/effect/turf_decal/siding/dark{
	dir = 6
	},
/obj/structure/weightmachine/weightlifter,
/turf/open/floor/carpet/black,
/area/hilbertshotel)
"ut" = (
/obj/effect/turf_decal/siding/dark/corner{
	dir = 8
	},
/turf/open/floor/carpet/black,
/area/hilbertshotel)
"vE" = (
/obj/effect/turf_decal/tile/neutral,
/obj/effect/turf_decal/tile/neutral{
	dir = 1
	},
/obj/effect/turf_decal/tile/neutral{
	dir = 4
	},
/obj/effect/turf_decal/tile/neutral{
	dir = 8
	},
/obj/effect/turf_decal/tile/dark_blue{
	dir = 4
	},
/obj/effect/turf_decal/tile/dark_blue{
	dir = 4
	},
/obj/effect/turf_decal/tile/dark_blue{
	dir = 4
	},
/obj/effect/turf_decal/tile/dark_blue,
/obj/effect/turf_decal/tile/dark_blue,
/obj/effect/turf_decal/tile/dark_blue,
/turf/open/floor/plasteel/dark,
/area/hilbertshotel)
"vL" = (
/turf/open/floor/carpet/royalblack,
/area/hilbertshotel)
"vT" = (
/turf/open/floor/catwalk_floor,
/area/hilbertshotel)
"vV" = (
/obj/effect/turf_decal/siding{
	dir = 2
	},
/obj/machinery/light,
/turf/open/floor/iron/white/small,
/area/hilbertshotel)
"wm" = (
/obj/effect/turf_decal/siding{
	dir = 9
	},
/turf/open/floor/iron/white/small,
/area/hilbertshotel)
"wy" = (
/obj/structure/punching_bag,
/turf/open/floor/carpet/black,
/area/hilbertshotel)
"wD" = (
/obj/machinery/vending/kink{
	extended_inventory = 1;
	shut_up = 1
	},
/turf/open/floor/plasteel/dark,
/area/hilbertshotel)
"wE" = (
/obj/structure/window/reinforced{
	dir = 1
	},
/obj/structure/window/reinforced{
	dir = 4
	},
/obj/structure/table/glass,
/obj/structure/bedsheetbin/towel,
/obj/effect/turf_decal/siding{
	dir = 9
	},
/obj/effect/turf_decal/siding{
	dir = 4
	},
/turf/open/floor/iron/white/small,
/area/hilbertshotel)
"wJ" = (
/obj/structure/sign/logo{
	icon_state = "nanotrasen_sign2"
	},
/turf/closed/indestructible/wall,
/area/hilbertshotel)
"xC" = (
/obj/effect/turf_decal/tile/neutral{
	dir = 1
	},
/obj/effect/turf_decal/tile/neutral{
	dir = 4
	},
/obj/effect/turf_decal/tile/neutral{
	dir = 8
	},
/obj/effect/turf_decal/tile/neutral,
/obj/structure/window/reinforced{
	dir = 8
	},
/obj/structure/window/reinforced{
	dir = 1;
	layer = 2.9
	},
/obj/effect/turf_decal/tile/dark_red{
	dir = 1
	},
/obj/effect/turf_decal/tile/dark_red{
	dir = 1
	},
/obj/effect/turf_decal/tile/dark_red{
	dir = 1
	},
/obj/effect/turf_decal/tile/dark_red{
	dir = 8
	},
/obj/effect/turf_decal/tile/dark_red{
	dir = 8
	},
/obj/effect/turf_decal/tile/dark_red{
	dir = 8
	},
/obj/effect/turf_decal/tile/dark_blue{
	dir = 4
	},
/obj/effect/turf_decal/tile/dark_blue{
	dir = 4
	},
/obj/effect/turf_decal/tile/dark_blue{
	dir = 4
	},
/turf/open/floor/plasteel/dark,
/area/hilbertshotel)
"xD" = (
/obj/effect/turf_decal/siding/wood{
	dir = 1
	},
/obj/machinery/door/window{
	dir = 1
	},
/turf/open/floor/carpet/royalblack,
/area/hilbertshotel)
"xU" = (
/obj/effect/turf_decal/siding/dark{
	dir = 10
	},
/obj/machinery/jukebox{
	req_one_access = null;
	set_obj_flags = "EMAGGED"
	},
/turf/open/floor/carpet/black,
/area/hilbertshotel)
"xX" = (
/obj/structure/sign/logo{
	icon_state = "nanotrasen_sign4"
	},
/turf/closed/indestructible/wall,
/area/hilbertshotel)
"ya" = (
/obj/structure/pool/Lboard,
/turf/open/pool,
/area/hilbertshotel)
"yE" = (
/obj/effect/turf_decal/tile/bar{
	dir = 8
	},
/obj/effect/turf_decal/tile/bar{
	dir = 1
	},
/obj/machinery/light{
	dir = 8
	},
/turf/open/floor/plasteel/shuttle,
/area/hilbertshotel)
"zw" = (
/obj/structure/closet/athletic_mixed,
/turf/open/floor/plasteel/dark,
/area/hilbertshotel)
"zJ" = (
/turf/open/floor/carpet/black,
/area/hilbertshotel)
"Aq" = (
/obj/structure/chair/pew/left{
	dir = 4
	},
/turf/open/floor/wood/wood_tiled,
/area/hilbertshotel)
"Au" = (
/obj/structure/window/reinforced/tinted/frosted{
	dir = 1
	},
/obj/effect/turf_decal/siding/wood{
	dir = 6
	},
/turf/open/floor/wood,
/area/hilbertshotel)
"Bu" = (
/obj/item/mop,
/obj/structure/mopbucket,
/turf/open/floor/plasteel/dark,
/area/hilbertshotel)
"BB" = (
/obj/item/toy/beach_ball/holoball{
	pixel_y = 17
	},
/obj/structure/rack/shelf,
/obj/item/clothing/gloves/boxing/modern,
/obj/item/clothing/gloves/boxing/modern{
	pixel_y = -13
	},
/turf/open/floor/plasteel/dark,
/area/hilbertshotel)
"CG" = (
/obj/structure/window/reinforced/tinted/frosted{
	dir = 1
	},
/obj/effect/turf_decal/siding/wood{
	dir = 10
	},
/obj/structure/table/glass,
/obj/structure/bedsheetbin/towel,
/turf/open/floor/wood,
/area/hilbertshotel)
"CU" = (
/obj/effect/turf_decal/siding{
	dir = 10
	},
/turf/open/floor/iron/white/small,
/area/hilbertshotel)
"Dq" = (
/obj/effect/turf_decal/tile/bar{
	dir = 8
	},
/obj/effect/turf_decal/tile/bar{
	dir = 1
	},
/obj/effect/turf_decal/tile/bar,
/turf/open/floor/plasteel/shuttle,
/area/hilbertshotel)
"Dt" = (
/obj/structure/chair/pew{
	dir = 4
	},
/obj/machinery/light/floor,
/turf/open/floor/wood/wood_tiled,
/area/hilbertshotel)
"EF" = (
/obj/structure/pool/ladder{
	dir = 2;
	pixel_y = 24
	},
/turf/open/pool,
/area/hilbertshotel)
"ET" = (
/obj/structure/table/glass,
/obj/effect/turf_decal/siding/wood{
	dir = 8
	},
/obj/item/reagent_containers/food/snacks/candy_corn,
/obj/item/reagent_containers/food/snacks/candyheart,
/obj/item/reagent_containers/food/snacks/candy{
	pixel_x = -5;
	pixel_y = 4
	},
/obj/item/reagent_containers/food/snacks/candy_corn{
	pixel_x = -5;
	pixel_y = 6
	},
/obj/item/reagent_containers/food/snacks/candyheart{
	pixel_x = 6;
	pixel_y = 5
	},
/obj/item/reagent_containers/food/snacks/special_candy{
	pixel_x = 10
	},
/obj/item/reagent_containers/glass/bowl{
	pixel_y = -5
	},
/turf/open/floor/carpet/royalblack,
/area/hilbertshotel)
"EW" = (
/obj/effect/turf_decal/tile/neutral{
	dir = 1
	},
/obj/effect/turf_decal/tile/neutral{
	dir = 4
	},
/obj/effect/turf_decal/tile/neutral{
	dir = 8
	},
/obj/effect/turf_decal/tile/dark_red{
	dir = 8
	},
/obj/effect/turf_decal/tile/dark_red{
	dir = 8
	},
/obj/effect/turf_decal/tile/dark_red{
	dir = 8
	},
/obj/effect/turf_decal/tile/dark_blue{
	dir = 4
	},
/obj/effect/turf_decal/tile/dark_blue{
	dir = 4
	},
/obj/effect/turf_decal/tile/dark_blue{
	dir = 4
	},
/obj/effect/turf_decal/tile/neutral,
/obj/effect/turf_decal/tile/dark_blue,
/obj/effect/turf_decal/tile/dark_blue,
/obj/effect/turf_decal/tile/dark_blue,
/turf/open/floor/plasteel/dark,
/area/hilbertshotel)
"FW" = (
/obj/machinery/light{
	dir = 4
	},
/obj/effect/turf_decal/siding/dark{
	dir = 4
	},
/turf/open/floor/carpet/black,
/area/hilbertshotel)
"Gf" = (
/obj/structure/table/glass,
/obj/effect/turf_decal/siding/wood{
	dir = 1
	},
/turf/open/floor/carpet/royalblack,
/area/hilbertshotel)
"Gm" = (
/obj/structure/weightmachine/weightlifter,
/turf/open/floor/carpet/black,
/area/hilbertshotel)
"Gw" = (
/obj/effect/turf_decal/siding{
	dir = 2
	},
/turf/open/floor/iron/white/small,
/area/hilbertshotel)
"Gy" = (
/obj/effect/turf_decal/siding/dark{
	dir = 10
	},
/obj/structure/weightmachine/stacklifter,
/turf/open/floor/carpet/black,
/area/hilbertshotel)
"GJ" = (
/turf/closed/indestructible/hoteldoor{
	icon_state = "door_closed";
	icon = 'icons/obj/doors/puzzledoor/default.dmi'
	},
/area/hilbertshotel)
"Hu" = (
/obj/structure/chair/sofa/right{
	dir = 8
	},
/obj/machinery/light{
	dir = 4
	},
/turf/open/floor/plasteel/dark,
/area/hilbertshotel)
"HN" = (
/obj/machinery/door/window/southright{
	dir = 1
	},
/obj/effect/turf_decal/siding/wood,
/obj/structure/fans/tiny/invisible,
/turf/open/floor/wood,
/area/hilbertshotel)
"Iq" = (
/obj/effect/turf_decal/tile/neutral,
/obj/effect/turf_decal/tile/neutral{
	dir = 4
	},
/obj/effect/turf_decal/tile/neutral{
	dir = 8
	},
/obj/structure/window/reinforced{
	dir = 1;
	layer = 2.9
	},
/obj/effect/turf_decal/tile/neutral{
	dir = 1
	},
/obj/effect/turf_decal/tile/dark_blue{
	dir = 4
	},
/obj/effect/turf_decal/tile/dark_blue{
	dir = 4
	},
/obj/effect/turf_decal/tile/dark_blue{
	dir = 4
	},
/obj/effect/turf_decal/tile/dark_blue{
	dir = 1
	},
/obj/effect/turf_decal/tile/dark_blue{
	dir = 1
	},
/obj/effect/turf_decal/tile/dark_blue{
	dir = 1
	},
/turf/open/floor/plasteel/dark,
/area/hilbertshotel)
"JW" = (
/obj/effect/turf_decal/siding/dark{
	dir = 4
	},
/turf/open/floor/carpet/black,
/area/hilbertshotel)
"Kz" = (
/obj/machinery/door/airlock/wood,
/turf/open/floor/plasteel/dark,
/area/hilbertshotel)
"KG" = (
/turf/open/floor/wood/wood_tiled,
/area/hilbertshotel)
"KL" = (
/obj/structure/table/glass,
/obj/item/storage/box/donkpockets{
	pixel_x = 3;
	pixel_y = 3
	},
/obj/effect/turf_decal/tile/bar{
	dir = 1
	},
/obj/effect/turf_decal/tile/bar{
	dir = 4
	},
/turf/open/floor/plasteel/shuttle,
/area/hilbertshotel)
"LU" = (
/obj/effect/turf_decal/tile/neutral,
/obj/effect/turf_decal/tile/neutral{
	dir = 1
	},
/obj/effect/turf_decal/tile/neutral{
	dir = 4
	},
/obj/effect/turf_decal/tile/neutral{
	dir = 8
	},
/obj/machinery/door/window{
	dir = 8;
	name = "Fitness Ring"
	},
/obj/item/clothing/gloves/boxing,
/obj/effect/turf_decal/tile/dark_red{
	dir = 8
	},
/obj/effect/turf_decal/tile/dark_red{
	dir = 8
	},
/obj/effect/turf_decal/tile/dark_red{
	dir = 8
	},
/obj/effect/turf_decal/tile/dark_red,
/obj/effect/turf_decal/tile/dark_red,
/obj/effect/turf_decal/tile/dark_red,
/obj/effect/turf_decal/tile/dark_red,
/obj/effect/turf_decal/tile/dark_red{
	dir = 1
	},
/obj/effect/turf_decal/tile/dark_red{
	dir = 1
	},
/obj/effect/turf_decal/tile/dark_red{
	dir = 1
	},
/obj/effect/turf_decal/tile/dark_red{
	dir = 1
	},
/turf/open/floor/plasteel/dark,
/area/hilbertshotel)
"ME" = (
/obj/structure/pool/Rboard,
/obj/structure/window/reinforced{
	dir = 4
	},
/obj/effect/turf_decal/siding{
	dir = 4
	},
/obj/effect/turf_decal/siding{
	dir = 4
	},
/turf/open/floor/iron/white/small,
/area/hilbertshotel)
"MT" = (
/obj/structure/filingcabinet,
/turf/open/floor/carpet/royalblack,
/area/hilbertshotel)
"NC" = (
/obj/structure/sink/directional{
	pixel_y = 29
	},
/obj/structure/chair/pew/left{
	dir = 8
	},
/turf/open/floor/wood/wood_tiled,
/area/hilbertshotel)
"OE" = (
/obj/effect/turf_decal/tile/neutral,
/obj/effect/turf_decal/tile/neutral{
	dir = 1
	},
/obj/effect/turf_decal/tile/neutral{
	dir = 4
	},
/obj/effect/turf_decal/tile/neutral{
	dir = 8
	},
/obj/structure/window/reinforced{
	dir = 8
	},
/obj/effect/turf_decal/tile/dark_red{
	dir = 1
	},
/obj/effect/turf_decal/tile/dark_red{
	dir = 1
	},
/obj/effect/turf_decal/tile/dark_red{
	dir = 1
	},
/obj/effect/turf_decal/tile/dark_red{
	dir = 8
	},
/obj/effect/turf_decal/tile/dark_red{
	dir = 8
	},
/obj/effect/turf_decal/tile/dark_red{
	dir = 8
	},
/turf/open/floor/plasteel/dark,
/area/hilbertshotel)
"OQ" = (
/obj/structure/pool/Lboard,
/obj/structure/pool/Lboard,
/obj/structure/fluff/railing{
	dir = 1;
	pixel_y = -32
	},
/turf/open/pool,
/area/hilbertshotel)
"OW" = (
/turf/open/floor/plasteel/dark,
/area/hilbertshotel)
"PW" = (
/obj/effect/turf_decal/tile/neutral,
/obj/effect/turf_decal/tile/neutral{
	dir = 1
	},
/obj/effect/turf_decal/tile/neutral{
	dir = 4
	},
/obj/effect/turf_decal/tile/neutral{
	dir = 8
	},
/obj/effect/turf_decal/tile/dark_red,
/obj/effect/turf_decal/tile/dark_red,
/obj/effect/turf_decal/tile/dark_red{
	dir = 8
	},
/obj/effect/turf_decal/tile/dark_red{
	dir = 8
	},
/obj/effect/turf_decal/tile/dark_red,
/obj/effect/turf_decal/tile/dark_red{
	dir = 8
	},
/turf/open/floor/plasteel/dark,
/area/hilbertshotel)
"Qr" = (
/obj/effect/turf_decal/siding/dark{
	dir = 1
	},
/obj/item/toy/beach_ball/holoball{
	pixel_y = 9;
	pixel_x = 9
	},
/obj/machinery/light{
	dir = 1;
	light_color = "#cee5d2"
	},
/turf/open/floor/carpet/black,
/area/hilbertshotel)
"QI" = (
/obj/effect/turf_decal/tile/bar{
	dir = 4
	},
/obj/effect/turf_decal/tile/bar,
/turf/open/floor/plasteel/shuttle,
/area/hilbertshotel)
"QS" = (
/obj/effect/turf_decal/siding/dark/corner,
/turf/open/floor/carpet/black,
/area/hilbertshotel)
"Rt" = (
/obj/structure/falsewall,
/turf/open/floor/plasteel/dark,
/area/hilbertshotel)
"Rz" = (
/obj/effect/turf_decal/tile/bar,
/obj/effect/turf_decal/tile/bar{
	dir = 4
	},
/turf/open/floor/plasteel/shuttle,
/area/hilbertshotel)
"RY" = (
/obj/structure/fluff/railing{
	dir = 1;
	pixel_y = -32
	},
/turf/open/pool,
/area/hilbertshotel)
"Si" = (
/obj/machinery/telecomms/relay/preset/auto,
/turf/open/floor/catwalk_floor,
/area/hilbertshotel)
"Tn" = (
/obj/effect/turf_decal/tile/neutral,
/obj/effect/turf_decal/tile/neutral{
	dir = 1
	},
/obj/effect/turf_decal/tile/neutral{
	dir = 4
	},
/obj/effect/turf_decal/tile/neutral{
	dir = 8
	},
/turf/open/floor/plasteel/dark,
/area/hilbertshotel)
"Ur" = (
/obj/structure/chair/sofa/right/brown,
/obj/effect/turf_decal/tile/bar{
	dir = 1
	},
/obj/effect/turf_decal/tile/bar{
	dir = 4
	},
/obj/effect/turf_decal/tile/bar{
	dir = 8
	},
/turf/open/floor/plasteel/shuttle,
/area/hilbertshotel)
"UA" = (
/obj/effect/turf_decal/tile/bar{
	dir = 8
	},
/obj/effect/turf_decal/tile/bar{
	dir = 1
	},
/turf/open/floor/plasteel/shuttle,
/area/hilbertshotel)
"Wj" = (
/obj/structure/chair/pew{
	dir = 8
	},
/obj/machinery/light/floor,
/turf/open/floor/wood/wood_tiled,
/area/hilbertshotel)
"Xf" = (
/obj/effect/turf_decal/tile/bar,
/obj/effect/turf_decal/tile/bar{
	dir = 8
	},
/turf/open/floor/plasteel/shuttle,
/area/hilbertshotel)
"XB" = (
/obj/effect/turf_decal/tile/neutral,
/obj/effect/turf_decal/tile/neutral{
	dir = 1
	},
/obj/effect/turf_decal/tile/neutral{
	dir = 4
	},
/obj/effect/turf_decal/tile/neutral{
	dir = 8
	},
/obj/machinery/door/window{
	dir = 1;
	name = "Fitness Ring"
	},
/obj/item/clothing/gloves/boxing/blue,
/obj/effect/turf_decal/tile/dark_blue{
	dir = 4
	},
/obj/effect/turf_decal/tile/dark_blue{
	dir = 4
	},
/obj/effect/turf_decal/tile/dark_blue{
	dir = 4
	},
/obj/effect/turf_decal/tile/dark_blue,
/obj/effect/turf_decal/tile/dark_blue,
/obj/effect/turf_decal/tile/dark_blue,
/obj/effect/turf_decal/tile/dark_blue{
	dir = 1
	},
/obj/effect/turf_decal/tile/dark_blue{
	dir = 1
	},
/obj/effect/turf_decal/tile/dark_blue{
	dir = 1
	},
/turf/open/floor/plasteel/dark,
/area/hilbertshotel)
"XH" = (
/obj/structure/window/reinforced/tinted/frosted{
	dir = 1
	},
/obj/effect/turf_decal/siding/wood,
/turf/open/floor/wood,
/area/hilbertshotel)
"YA" = (
/obj/structure/reagent_dispensers/water_cooler,
/turf/open/floor/plasteel/dark,
/area/hilbertshotel)
"YK" = (
/obj/structure/chair/sofa/left/brown,
/obj/effect/turf_decal/tile/bar{
	dir = 4
	},
/obj/effect/turf_decal/tile/bar,
/obj/effect/turf_decal/tile/bar{
	dir = 1
	},
/turf/open/floor/plasteel/shuttle,
/area/hilbertshotel)
"YV" = (
/obj/structure/sign/logo{
	icon_state = "nanotrasen_sign5"
	},
/turf/closed/indestructible/wall,
/area/hilbertshotel)
"Ze" = (
/obj/structure/pool/Lboard,
/obj/structure/fluff/railing{
	pixel_y = 32
	},
/turf/open/pool,
/area/hilbertshotel)
"Zm" = (
/obj/effect/turf_decal/siding/dark{
	dir = 1
	},
/turf/open/floor/carpet/black,
/area/hilbertshotel)
"ZU" = (
/obj/effect/turf_decal/tile/bar,
/obj/effect/turf_decal/tile/bar{
	dir = 8
	},
/obj/effect/turf_decal/tile/bar{
	dir = 4
	},
/turf/open/floor/plasteel/shuttle,
/area/hilbertshotel)
"ZZ" = (
/turf/open/pool,
/area/hilbertshotel)

(1,1,1) = {"
aN
aN
aN
aN
aN
GJ
aN
aN
aN
aN
aN
qj
gV
aN
aN
aN
"}
(2,1,1) = {"
jP
Ur
yE
UA
UA
UA
yE
Dq
aN
wm
aR
ix
ix
aR
CU
aN
"}
(3,1,1) = {"
wJ
oR
tB
nk
Rz
Rz
Rz
pI
aN
lc
qi
ZZ
ZZ
RY
Gw
aN
"}
(4,1,1) = {"
ed
KL
tB
Xf
mc
tX
ET
tX
aN
lc
qi
ZZ
ZZ
RY
rg
aN
"}
(5,1,1) = {"
xX
dI
tB
Xf
Gf
pJ
vL
vL
aN
lc
EF
ZZ
ZZ
oz
Gw
aN
"}
(6,1,1) = {"
YV
YK
QI
ZU
xD
bW
vL
MT
aN
lc
qi
ZZ
ZZ
RY
Gw
aN
"}
(7,1,1) = {"
aN
aN
cT
aN
aN
aN
aN
aN
aN
lc
Ze
ya
ya
OQ
vV
aN
"}
(8,1,1) = {"
aN
YA
OW
oZ
zw
aN
fH
xU
wE
fI
ME
bd
bd
eW
kq
aN
"}
(9,1,1) = {"
aN
OW
OW
OW
OW
cT
Zm
ut
fo
fo
fo
fo
fo
fo
Gy
aN
"}
(10,1,1) = {"
aN
zw
zw
Hu
sK
aN
Zm
wy
zJ
Gm
zJ
gP
zJ
zJ
aP
aN
"}
(11,1,1) = {"
aN
Rt
aN
aN
aN
aN
Qr
QS
JW
kY
JW
JW
FW
JW
uh
aN
"}
(12,1,1) = {"
aN
wD
aN
fb
Dt
Aq
CG
aP
xC
mU
OE
LU
aN
Kz
aN
aN
"}
(13,1,1) = {"
aN
aN
aN
ly
KG
KG
XH
aP
Iq
Tn
Tn
PW
aN
OW
Bu
aN
"}
(14,1,1) = {"
vT
aN
hw
KG
KG
KG
HN
aP
jn
Tn
Tn
nJ
aN
od
pE
aN
"}
(15,1,1) = {"
Si
aN
aN
NC
Wj
qv
Au
jb
XB
vE
vE
EW
aN
OW
BB
aN
"}
(16,1,1) = {"
aN
aN
aN
aN
aN
aN
aN
aN
aN
aN
aN
aN
aN
aN
aN
aN
"}
